fra;jour;n_dose1;n_complet;n_rappel;n_2_rappel;n_cum_dose1;n_cum_complet;n_cum_rappel;n_cum_2_rappel;couv_dose1;couv_complet;couv_rappel;couv_2_rappel
FR;2020-12-27;602;55;0;0;602;55;0;0;0.0;0.0;0.0;0.0
FR;2020-12-28;668;42;0;0;1270;97;0;0;0.0;0.0;0.0;0.0
FR;2020-12-29;374;19;0;0;1644;116;0;0;0.0;0.0;0.0;0.0
FR;2020-12-30;440;18;0;0;2084;134;0;0;0.0;0.0;0.0;0.0
FR;2020-12-31;429;24;0;0;2513;158;0;0;0.0;0.0;0.0;0.0
FR;2021-01-01;1136;65;0;0;3649;223;0;0;0.0;0.0;0.0;0.0
FR;2021-01-02;356;30;0;0;4005;253;0;0;0.0;0.0;0.0;0.0
FR;2021-01-03;401;27;0;0;4406;280;0;0;0.0;0.0;0.0;0.0
FR;2021-01-04;2089;48;0;0;6495;328;0;0;0.0;0.0;0.0;0.0
FR;2021-01-05;7632;127;0;0;14127;455;0;0;0.0;0.0;0.0;0.0
FR;2021-01-06;12423;120;0;0;26550;575;0;0;0.0;0.0;0.0;0.0
FR;2021-01-07;29446;157;0;0;55996;732;0;0;0.1;0.0;0.0;0.0
FR;2021-01-08;37121;195;0;0;93117;927;0;0;0.1;0.0;0.0;0.0
FR;2021-01-09;11209;75;0;0;104326;1002;0;0;0.2;0.0;0.0;0.0
FR;2021-01-10;5996;24;0;0;110322;1026;0;0;0.2;0.0;0.0;0.0
FR;2021-01-11;39924;223;0;0;150246;1249;0;0;0.2;0.0;0.0;0.0
FR;2021-01-12;62125;311;0;0;212371;1560;0;0;0.3;0.0;0.0;0.0
FR;2021-01-13;65102;429;0;0;277473;1989;0;0;0.4;0.0;0.0;0.0
FR;2021-01-14;83120;1191;0;0;360593;3180;0;0;0.5;0.0;0.0;0.0
FR;2021-01-15;68992;559;0;0;429585;3739;0;0;0.6;0.0;0.0;0.0
FR;2021-01-16;20208;186;0;0;449793;3925;0;0;0.7;0.0;0.0;0.0
FR;2021-01-17;10977;131;0;0;460770;4056;0;0;0.7;0.0;0.0;0.0
FR;2021-01-18;85880;613;0;0;546650;4669;0;0;0.8;0.0;0.0;0.0
FR;2021-01-19;130573;866;0;0;677223;5535;0;0;1.0;0.0;0.0;0.0
FR;2021-01-20;137526;853;0;0;814749;6388;0;0;1.2;0.0;0.0;0.0
FR;2021-01-21;158376;969;0;0;973125;7357;0;0;1.4;0.0;0.0;0.0
FR;2021-01-22;121041;837;0;0;1094166;8194;0;0;1.6;0.0;0.0;0.0
FR;2021-01-23;38467;204;0;0;1132633;8398;0;0;1.7;0.0;0.0;0.0
FR;2021-01-24;9740;137;0;0;1142373;8535;0;0;1.7;0.0;0.0;0.0
FR;2021-01-25;78223;1632;0;0;1220596;10167;0;0;1.8;0.0;0.0;0.0
FR;2021-01-26;100364;3767;0;0;1320960;13934;0;0;2.0;0.0;0.0;0.0
FR;2021-01-27;107221;6671;0;0;1428181;20605;0;0;2.1;0.0;0.0;0.0
FR;2021-01-28;124330;15847;0;0;1552511;36452;0;0;2.3;0.1;0.0;0.0
FR;2021-01-29;92171;18280;0;0;1644682;54732;0;0;2.5;0.1;0.0;0.0
FR;2021-01-30;29112;4427;0;0;1673794;59159;0;0;2.5;0.1;0.0;0.0
FR;2021-01-31;5228;1774;0;0;1679022;60933;0;0;2.5;0.1;0.0;0.0
FR;2021-02-01;53107;21779;0;0;1732129;82712;0;0;2.6;0.1;0.0;0.0
FR;2021-02-02;72280;36213;0;0;1804409;118925;0;0;2.7;0.2;0.0;0.0
FR;2021-02-03;72291;38484;0;0;1876700;157409;0;0;2.8;0.2;0.0;0.0
FR;2021-02-04;82049;52024;0;0;1958749;209433;0;0;2.9;0.3;0.0;0.0
FR;2021-02-05;68216;46491;0;0;2026965;255924;0;0;3.0;0.4;0.0;0.0
FR;2021-02-06;23108;10979;0;0;2050073;266903;0;0;3.1;0.4;0.0;0.0
FR;2021-02-07;5182;5424;0;0;2055255;272327;0;0;3.1;0.4;0.0;0.0
FR;2021-02-08;46817;47253;0;0;2102072;319580;0;0;3.1;0.5;0.0;0.0
FR;2021-02-09;65992;75499;0;0;2168064;395079;0;0;3.2;0.6;0.0;0.0
FR;2021-02-10;70985;80543;0;0;2239049;475622;0;0;3.3;0.7;0.0;0.0
FR;2021-02-11;87240;103050;0;0;2326289;578672;0;0;3.5;0.9;0.0;0.0
FR;2021-02-12;79290;76571;0;0;2405579;655243;0;0;3.6;1.0;0.0;0.0
FR;2021-02-13;22353;19811;0;0;2427932;675054;0;0;3.6;1.0;0.0;0.0
FR;2021-02-14;5071;7303;0;0;2433003;682357;0;0;3.6;1.0;0.0;0.0
FR;2021-02-15;38069;77431;0;0;2471072;759788;0;0;3.7;1.1;0.0;0.0
FR;2021-02-16;50364;101722;0;0;2521436;861510;0;0;3.8;1.3;0.0;0.0
FR;2021-02-17;50501;105811;0;0;2571937;967321;0;0;3.8;1.4;0.0;0.0
FR;2021-02-18;69760;122299;0;0;2641697;1089620;0;0;3.9;1.6;0.0;0.0
FR;2021-02-19;65050;92756;0;0;2706747;1182376;0;0;4.0;1.8;0.0;0.0
FR;2021-02-20;18574;28862;0;0;2725321;1211238;0;0;4.1;1.8;0.0;0.0
FR;2021-02-21;3314;6369;0;0;2728635;1217607;0;0;4.1;1.8;0.0;0.0
FR;2021-02-22;37478;74000;0;0;2766113;1291607;0;0;4.1;1.9;0.0;0.0
FR;2021-02-23;53761;85785;0;0;2819874;1377392;0;0;4.2;2.1;0.0;0.0
FR;2021-02-24;59981;83198;0;0;2879855;1460590;0;0;4.3;2.2;0.0;0.0
FR;2021-02-25;100544;94250;0;0;2980399;1554840;0;0;4.4;2.3;0.0;0.0
FR;2021-02-26;113432;73721;0;0;3093831;1628561;0;0;4.6;2.4;0.0;0.0
FR;2021-02-27;52091;23354;0;0;3145922;1651915;0;0;4.7;2.5;0.0;0.0
FR;2021-02-28;6192;4471;0;0;3152114;1656386;0;0;4.7;2.5;0.0;0.0
FR;2021-03-01;65835;55060;0;0;3217949;1711446;0;0;4.8;2.6;0.0;0.0
FR;2021-03-02;101348;69557;0;0;3319297;1781003;0;0;4.9;2.7;0.0;0.0
FR;2021-03-03;116466;69104;0;0;3435763;1850107;0;0;5.1;2.8;0.0;0.0
FR;2021-03-04;163585;75765;0;0;3599348;1925872;0;0;5.4;2.9;0.0;0.0
FR;2021-03-05;200885;69724;0;0;3800233;1995596;0;0;5.7;3.0;0.0;0.0
FR;2021-03-06;207927;22999;0;0;4008160;2018595;0;0;6.0;3.0;0.0;0.0
FR;2021-03-07;121250;8267;0;0;4129410;2026862;0;0;6.2;3.0;0.0;0.0
FR;2021-03-08;107114;53750;0;0;4236524;2080612;0;0;6.3;3.1;0.0;0.0
FR;2021-03-09;172412;61895;0;0;4408936;2142507;0;0;6.6;3.2;0.0;0.0
FR;2021-03-10;178938;62687;0;0;4587874;2205194;0;0;6.8;3.3;0.0;0.0
FR;2021-03-11;242833;71520;0;0;4830707;2276714;0;0;7.2;3.4;0.0;0.0
FR;2021-03-12;294777;62764;0;0;5125484;2339478;0;0;7.6;3.5;0.0;0.0
FR;2021-03-13;231373;21302;0;0;5356857;2360780;0;0;8.0;3.5;0.0;0.0
FR;2021-03-14;63337;5318;0;0;5420194;2366098;0;0;8.1;3.5;0.0;0.0
FR;2021-03-15;158601;36776;0;0;5578795;2402874;0;0;8.3;3.6;0.0;0.0
FR;2021-03-16;141539;43213;0;0;5720334;2446087;0;0;8.5;3.6;0.0;0.0
FR;2021-03-17;150447;42920;0;0;5870781;2489007;0;0;8.7;3.7;0.0;0.0
FR;2021-03-18;167786;50037;0;0;6038567;2539044;0;0;9.0;3.8;0.0;0.0
FR;2021-03-19;229964;44488;0;0;6268531;2583532;0;0;9.3;3.8;0.0;0.0
FR;2021-03-20;166643;16200;0;0;6435174;2599732;0;0;9.6;3.9;0.0;0.0
FR;2021-03-21;49919;4254;0;0;6485093;2603986;0;0;9.7;3.9;0.0;0.0
FR;2021-03-22;169997;39435;0;0;6655090;2643421;0;0;9.9;3.9;0.0;0.0
FR;2021-03-23;250329;50134;0;0;6905419;2693555;0;0;10.3;4.0;0.0;0.0
FR;2021-03-24;256855;51696;0;0;7162274;2745251;0;0;10.7;4.1;0.0;0.0
FR;2021-03-25;341755;55804;0;0;7504029;2801055;0;0;11.2;4.2;0.0;0.0
FR;2021-03-26;358750;53625;0;0;7862779;2854680;0;0;11.7;4.3;0.0;0.0
FR;2021-03-27;195240;23166;0;0;8058019;2877846;0;0;12.0;4.3;0.0;0.0
FR;2021-03-28;59323;6071;0;0;8117342;2883917;0;0;12.1;4.3;0.0;0.0
FR;2021-03-29;202934;60676;0;0;8320276;2944593;0;0;12.4;4.4;0.0;0.0
FR;2021-03-30;285419;79983;0;0;8605695;3024576;0;0;12.8;4.5;0.0;0.0
FR;2021-03-31;262966;83858;0;0;8868661;3108434;0;0;13.2;4.6;0.0;0.0
FR;2021-04-01;315392;102785;0;0;9184053;3211219;0;0;13.7;4.8;0.0;0.0
FR;2021-04-02;281284;104515;0;0;9465337;3315734;0;0;14.1;4.9;0.0;0.0
FR;2021-04-03;141050;67159;0;0;9606387;3382893;0;0;14.3;5.0;0.0;0.0
FR;2021-04-04;46461;20772;0;0;9652848;3403665;0;0;14.4;5.1;0.0;0.0
FR;2021-04-05;63307;13440;0;0;9716155;3417105;0;0;14.5;5.1;0.0;0.0
FR;2021-04-06;217147;118026;0;0;9933302;3535131;0;0;14.8;5.3;0.0;0.0
FR;2021-04-07;260193;126634;0;0;10193495;3661765;0;0;15.2;5.5;0.0;0.0
FR;2021-04-08;337740;137233;0;0;10531235;3798998;0;0;15.7;5.7;0.0;0.0
FR;2021-04-09;410084;133641;0;0;10941319;3932639;0;0;16.3;5.9;0.0;0.0
FR;2021-04-10;212583;90954;0;0;11153902;4023593;0;0;16.6;6.0;0.0;0.0
FR;2021-04-11;56123;36938;0;0;11210025;4060531;0;0;16.7;6.1;0.0;0.0
FR;2021-04-12;237004;124727;0;0;11447029;4185258;0;0;17.1;6.2;0.0;0.0
FR;2021-04-13;309419;157334;0;0;11756448;4342592;0;0;17.5;6.5;0.0;0.0
FR;2021-04-14;294442;152574;0;0;12050890;4495166;0;0;18.0;6.7;0.0;0.0
FR;2021-04-15;337011;163836;0;0;12387901;4659002;0;0;18.5;6.9;0.0;0.0
FR;2021-04-16;339227;160483;0;0;12727128;4819485;0;0;19.0;7.2;0.0;0.0
FR;2021-04-17;188626;97659;0;0;12915754;4917144;0;0;19.2;7.3;0.0;0.0
FR;2021-04-18;51603;37771;0;0;12967357;4954915;0;0;19.3;7.4;0.0;0.0
FR;2021-04-19;205641;147266;0;0;13172998;5102181;0;0;19.6;7.6;0.0;0.0
FR;2021-04-20;254348;182437;0;0;13427346;5284618;0;0;20.0;7.9;0.0;0.0
FR;2021-04-21;253179;181038;0;0;13680525;5465656;0;0;20.4;8.1;0.0;0.0
FR;2021-04-22;287492;203280;0;0;13968017;5668936;0;0;20.8;8.4;0.0;0.0
FR;2021-04-23;297923;202448;0;0;14265940;5871384;0;0;21.3;8.7;0.0;0.0
FR;2021-04-24;190412;121965;0;0;14456352;5993349;0;0;21.5;8.9;0.0;0.0
FR;2021-04-25;69541;42500;0;0;14525893;6035849;0;0;21.6;9.0;0.0;0.0
FR;2021-04-26;220894;169423;0;0;14746787;6205272;0;0;22.0;9.2;0.0;0.0
FR;2021-04-27;284549;210596;0;0;15031336;6415868;0;0;22.4;9.6;0.0;0.0
FR;2021-04-28;299446;208282;1;0;15330782;6624150;1;0;22.8;9.9;0.0;0.0
FR;2021-04-29;357058;231571;0;0;15687840;6855721;1;0;23.4;10.2;0.0;0.0
FR;2021-04-30;372140;224125;0;0;16059980;7079846;1;0;23.9;10.5;0.0;0.0
FR;2021-05-01;167602;63710;0;0;16227582;7143556;1;0;24.2;10.6;0.0;0.0
FR;2021-05-02;91708;43455;0;0;16319290;7187011;1;0;24.3;10.7;0.0;0.0
FR;2021-05-03;288857;188817;0;0;16608147;7375828;1;0;24.7;11.0;0.0;0.0
FR;2021-05-04;315594;250472;0;0;16923741;7626300;1;0;25.2;11.4;0.0;0.0
FR;2021-05-05;327104;249761;0;0;17250845;7876061;1;0;25.7;11.7;0.0;0.0
FR;2021-05-06;379423;273613;0;0;17630268;8149674;1;0;26.3;12.1;0.0;0.0
FR;2021-05-07;372682;298274;0;0;18002950;8447948;1;0;26.8;12.6;0.0;0.0
FR;2021-05-08;222136;82637;0;0;18225086;8530585;1;0;27.2;12.7;0.0;0.0
FR;2021-05-09;129683;54981;0;0;18354769;8585566;1;0;27.3;12.8;0.0;0.0
FR;2021-05-10;313298;254434;0;0;18668067;8840000;1;0;27.8;13.2;0.0;0.0
FR;2021-05-11;403818;296190;0;0;19071885;9136190;1;0;28.4;13.6;0.0;0.0
FR;2021-05-12;434032;269290;0;0;19505917;9405480;1;0;29.1;14.0;0.0;0.0
FR;2021-05-13;338552;78397;0;0;19844469;9483877;1;0;29.6;14.1;0.0;0.0
FR;2021-05-14;454052;202758;0;0;20298521;9686635;1;0;30.2;14.4;0.0;0.0
FR;2021-05-15;374922;120393;0;0;20673443;9807028;1;0;30.8;14.6;0.0;0.0
FR;2021-05-16;202724;34165;0;0;20876167;9841193;1;0;31.1;14.7;0.0;0.0
FR;2021-05-17;376066;178548;0;0;21252233;10019741;1;0;31.7;14.9;0.0;0.0
FR;2021-05-18;460062;192241;0;0;21712295;10211982;1;0;32.4;15.2;0.0;0.0
FR;2021-05-19;467324;181912;0;0;22179619;10393894;1;0;33.0;15.5;0.0;0.0
FR;2021-05-20;507460;204137;0;0;22687079;10598031;1;0;33.8;15.8;0.0;0.0
FR;2021-05-21;489599;220888;0;0;23176678;10818919;1;0;34.5;16.1;0.0;0.0
FR;2021-05-22;347142;108275;0;0;23523820;10927194;1;0;35.1;16.3;0.0;0.0
FR;2021-05-23;161663;26866;0;0;23685483;10954060;1;0;35.3;16.3;0.0;0.0
FR;2021-05-24;263147;53011;0;0;23948630;11007071;1;0;35.7;16.4;0.0;0.0
FR;2021-05-25;400199;225689;0;0;24348829;11232760;1;0;36.3;16.7;0.0;0.0
FR;2021-05-26;413393;226498;0;0;24762222;11459258;1;0;36.9;17.1;0.0;0.0
FR;2021-05-27;449740;265678;0;0;25211962;11724936;1;0;37.6;17.5;0.0;0.0
FR;2021-05-28;429484;317465;0;0;25641446;12042401;1;0;38.2;17.9;0.0;0.0
FR;2021-05-29;298945;182182;0;0;25940391;12224583;1;0;38.7;18.2;0.0;0.0
FR;2021-05-30;107120;42153;0;0;26047511;12266736;1;0;38.8;18.3;0.0;0.0
FR;2021-05-31;357971;241575;1;0;26405482;12508311;2;0;39.3;18.6;0.0;0.0
FR;2021-06-01;430881;302750;1;0;26836363;12811061;3;0;40.0;19.1;0.0;0.0
FR;2021-06-02;419451;278109;0;0;27255814;13089170;3;0;40.6;19.5;0.0;0.0
FR;2021-06-03;464740;313047;0;0;27720554;13402217;3;0;41.3;20.0;0.0;0.0
FR;2021-06-04;455711;361983;1;0;28176265;13764200;4;0;42.0;20.5;0.0;0.0
FR;2021-06-05;304751;222139;0;0;28481016;13986339;4;0;42.4;20.8;0.0;0.0
FR;2021-06-06;133241;61271;0;0;28614257;14047610;4;0;42.6;20.9;0.0;0.0
FR;2021-06-07;339076;298948;0;0;28953333;14346558;4;0;43.1;21.4;0.0;0.0
FR;2021-06-08;393569;337740;0;0;29346902;14684298;4;0;43.7;21.9;0.0;0.0
FR;2021-06-09;384675;319800;0;0;29731577;15004098;4;0;44.3;22.4;0.0;0.0
FR;2021-06-10;403972;338237;0;0;30135549;15342335;4;0;44.9;22.9;0.0;0.0
FR;2021-06-11;386467;407520;0;0;30522016;15749855;4;0;45.5;23.5;0.0;0.0
FR;2021-06-12;283206;243380;0;0;30805222;15993235;4;0;45.9;23.8;0.0;0.0
FR;2021-06-13;104833;84990;0;0;30910055;16078225;4;0;46.1;24.0;0.0;0.0
FR;2021-06-14;240652;384564;0;0;31150707;16462789;4;0;46.4;24.5;0.0;0.0
FR;2021-06-15;307994;424262;0;0;31458701;16887051;4;0;46.9;25.2;0.0;0.0
FR;2021-06-16;313846;395500;0;0;31772547;17282551;4;0;47.3;25.8;0.0;0.0
FR;2021-06-17;317562;413582;0;0;32090109;17696133;4;0;47.8;26.4;0.0;0.0
FR;2021-06-18;321556;485763;0;0;32411665;18181896;4;0;48.3;27.1;0.0;0.0
FR;2021-06-19;224306;300941;0;0;32635971;18482837;4;0;48.6;27.5;0.0;0.0
FR;2021-06-20;74371;111781;0;0;32710342;18594618;4;0;48.7;27.7;0.0;0.0
FR;2021-06-21;195571;427772;1;0;32905913;19022390;5;0;49.0;28.3;0.0;0.0
FR;2021-06-22;223010;499967;2;0;33128923;19522357;7;0;49.4;29.1;0.0;0.0
FR;2021-06-23;233869;474023;1;0;33362792;19996380;8;0;49.7;29.8;0.0;0.0
FR;2021-06-24;241734;447077;0;0;33604526;20443457;8;0;50.1;30.5;0.0;0.0
FR;2021-06-25;227470;561210;0;0;33831996;21004667;8;0;50.4;31.3;0.0;0.0
FR;2021-06-26;153192;395491;0;0;33985188;21400158;8;0;50.6;31.9;0.0;0.0
FR;2021-06-27;55863;165119;0;0;34041051;21565277;8;0;50.7;32.1;0.0;0.0
FR;2021-06-28;154618;478424;0;0;34195669;22043701;8;0;51.0;32.8;0.0;0.0
FR;2021-06-29;182547;538294;0;0;34378216;22581995;8;0;51.2;33.6;0.0;0.0
FR;2021-06-30;203842;517060;2;0;34582058;23099055;10;0;51.5;34.4;0.0;0.0
FR;2021-07-01;231113;497926;1;0;34813171;23596981;11;0;51.9;35.2;0.0;0.0
FR;2021-07-02;228333;562666;3;0;35041504;24159647;14;0;52.2;36.0;0.0;0.0
FR;2021-07-03;141939;395294;1;0;35183443;24554941;15;0;52.4;36.6;0.0;0.0
FR;2021-07-04;56694;150968;0;0;35240137;24705909;15;0;52.5;36.8;0.0;0.0
FR;2021-07-05;168234;449374;2;0;35408371;25155283;17;0;52.8;37.5;0.0;0.0
FR;2021-07-06;196568;511515;8;0;35604939;25666798;25;0;53.1;38.2;0.0;0.0
FR;2021-07-07;212964;477921;5;0;35817903;26144719;30;0;53.4;39.0;0.0;0.0
FR;2021-07-08;231448;468296;7;0;36049351;26613015;37;0;53.7;39.7;0.0;0.0
FR;2021-07-09;228350;557248;2;0;36277701;27170263;39;0;54.1;40.5;0.0;0.0
FR;2021-07-10;148537;368913;1;0;36426238;27539176;40;0;54.3;41.0;0.0;0.0
FR;2021-07-11;60143;121097;0;0;36486381;27660273;40;0;54.4;41.2;0.0;0.0
FR;2021-07-12;168960;513145;0;0;36655341;28173418;40;0;54.6;42.0;0.0;0.0
FR;2021-07-13;287073;586705;2;0;36942414;28760123;42;0;55.0;42.9;0.0;0.0
FR;2021-07-14;180899;187129;0;0;37123313;28947252;42;0;55.3;43.1;0.0;0.0
FR;2021-07-15;346880;572743;0;0;37470193;29519995;42;0;55.8;44.0;0.0;0.0
FR;2021-07-16;379910;575384;1;0;37850103;30095379;43;0;56.4;44.8;0.0;0.0
FR;2021-07-17;259657;368943;0;0;38109760;30464322;43;0;56.8;45.4;0.0;0.0
FR;2021-07-18;109668;133301;0;0;38219428;30597623;43;0;56.9;45.6;0.0;0.0
FR;2021-07-19;285318;480212;0;0;38504746;31077835;43;0;57.4;46.3;0.0;0.0
FR;2021-07-20;376733;524933;0;0;38881479;31602768;43;0;57.9;47.1;0.0;0.0
FR;2021-07-21;395631;483077;2;0;39277110;32085845;45;0;58.5;47.8;0.0;0.0
FR;2021-07-22;440886;472797;2;0;39717996;32558642;47;0;59.2;48.5;0.0;0.0
FR;2021-07-23;439984;511346;2;0;40157980;33069988;49;0;59.8;49.3;0.0;0.0
FR;2021-07-24;285184;322360;0;0;40443164;33392348;49;0;60.3;49.8;0.0;0.0
FR;2021-07-25;121054;100463;0;0;40564218;33492811;49;0;60.4;49.9;0.0;0.0
FR;2021-07-26;347272;385927;2;0;40911490;33878738;51;0;61.0;50.5;0.0;0.0
FR;2021-07-27;463894;401655;2;0;41375384;34280393;53;0;61.6;51.1;0.0;0.0
FR;2021-07-28;459311;367881;2;0;41834695;34648274;55;0;62.3;51.6;0.0;0.0
FR;2021-07-29;489687;358067;1;0;42324382;35006341;56;0;63.1;52.2;0.0;0.0
FR;2021-07-30;461640;381629;2;0;42786022;35387970;58;0;63.8;52.7;0.0;0.0
FR;2021-07-31;285345;231699;0;0;43071367;35619669;58;0;64.2;53.1;0.0;0.0
FR;2021-08-01;111943;65826;0;0;43183310;35685495;58;0;64.3;53.2;0.0;0.0
FR;2021-08-02;341229;285552;0;0;43524539;35971047;58;0;64.9;53.6;0.0;0.0
FR;2021-08-03;398424;305439;1;0;43922963;36276486;59;0;65.4;54.1;0.0;0.0
FR;2021-08-04;384650;266497;3;0;44307613;36542983;62;0;66.0;54.4;0.0;0.0
FR;2021-08-05;365985;282606;0;0;44673598;36825589;62;0;66.6;54.9;0.0;0.0
FR;2021-08-06;359570;327368;1;0;45033168;37152957;63;0;67.1;55.4;0.0;0.0
FR;2021-08-07;213036;210253;3;0;45246204;37363210;66;0;67.4;55.7;0.0;0.0
FR;2021-08-08;74133;73727;0;0;45320337;37436937;66;0;67.5;55.8;0.0;0.0
FR;2021-08-09;258580;298647;3;0;45578917;37735584;69;0;67.9;56.2;0.0;0.0
FR;2021-08-10;306614;324673;1;0;45885531;38060257;70;0;68.4;56.7;0.0;0.0
FR;2021-08-11;279542;302624;1;0;46165073;38362881;71;0;68.8;57.2;0.0;0.0
FR;2021-08-12;271393;321206;1;0;46436466;38684087;72;0;69.2;57.6;0.0;0.0
FR;2021-08-13;252038;317042;2;0;46688504;39001129;74;0;69.6;58.1;0.0;0.0
FR;2021-08-14;145279;219408;0;0;46833783;39220537;74;0;69.8;58.4;0.0;0.0
FR;2021-08-15;39308;55731;0;0;46873091;39276268;74;0;69.8;58.5;0.0;0.0
FR;2021-08-16;186047;346311;0;0;47059138;39622579;74;0;70.1;59.0;0.0;0.0
FR;2021-08-17;215562;369888;1;0;47274700;39992467;75;0;70.4;59.6;0.0;0.0
FR;2021-08-18;198935;355257;4;0;47473635;40347724;79;0;70.7;60.1;0.0;0.0
FR;2021-08-19;191896;356626;0;0;47665531;40704350;79;0;71.0;60.6;0.0;0.0
FR;2021-08-20;186362;397161;2;0;47851893;41101511;81;0;71.3;61.2;0.0;0.0
FR;2021-08-21;104756;254741;0;0;47956649;41356252;81;0;71.5;61.6;0.0;0.0
FR;2021-08-22;31889;92203;1;0;47988538;41448455;82;0;71.5;61.8;0.0;0.0
FR;2021-08-23;140892;380208;1;0;48129430;41828663;83;0;71.7;62.3;0.0;0.0
FR;2021-08-24;162404;403562;1;0;48291834;42232225;84;0;72.0;62.9;0.0;0.0
FR;2021-08-25;151062;376042;3;0;48442896;42608267;87;0;72.2;63.5;0.0;0.0
FR;2021-08-26;142753;368352;1;0;48585649;42976619;88;0;72.4;64.0;0.0;0.0
FR;2021-08-27;148367;415630;3;0;48734016;43392249;91;0;72.6;64.7;0.0;0.0
FR;2021-08-28;90609;265293;0;0;48824625;43657542;91;0;72.7;65.0;0.0;0.0
FR;2021-08-29;27304;88382;0;0;48851929;43745924;91;0;72.8;65.2;0.0;0.0
FR;2021-08-30;117324;342645;6024;0;48969253;44088569;6115;0;73.0;65.7;0.0;0.0
FR;2021-08-31;128716;354205;11874;2;49097969;44442774;17989;2;73.2;66.2;0.0;0.0
FR;2021-09-01;135784;302702;24308;1;49233753;44745476;42297;3;73.4;66.7;0.1;0.0
FR;2021-09-02;112621;262479;28877;1;49346374;45007955;71174;4;73.5;67.1;0.1;0.0
FR;2021-09-03;118201;309687;32959;6;49464575;45317642;104133;10;73.7;67.5;0.2;0.0
FR;2021-09-04;89813;230665;14076;5;49554388;45548307;118209;15;73.8;67.9;0.2;0.0
FR;2021-09-05;21339;48353;4733;0;49575727;45596660;122942;15;73.9;67.9;0.2;0.0
FR;2021-09-06;75331;191193;34241;2;49651058;45787853;157183;17;74.0;68.2;0.2;0.0
FR;2021-09-07;80116;191506;36107;3;49731174;45979359;193290;20;74.1;68.5;0.3;0.0
FR;2021-09-08;89860;216936;32456;6;49821034;46196295;225746;26;74.2;68.8;0.3;0.0
FR;2021-09-09;76687;174517;36527;16;49897721;46370812;262273;42;74.3;69.1;0.4;0.0
FR;2021-09-10;95625;215242;40520;13;49993346;46586054;302793;55;74.5;69.4;0.5;0.0
FR;2021-09-11;66783;178296;14312;1;50060129;46764350;317105;56;74.6;69.7;0.5;0.0
FR;2021-09-12;12795;34161;3161;2;50072924;46798511;320266;58;74.6;69.7;0.5;0.0
FR;2021-09-13;64376;134666;44053;29;50137300;46933177;364319;87;74.7;69.9;0.5;0.0
FR;2021-09-14;73327;136292;62049;53;50210627;47069469;426368;140;74.8;70.1;0.6;0.0
FR;2021-09-15;76419;174889;54775;99;50287046;47244358;481143;239;74.9;70.4;0.7;0.0
FR;2021-09-16;63761;117992;60025;125;50350807;47362350;541168;364;75.0;70.6;0.8;0.0
FR;2021-09-17;74976;159831;57237;90;50425783;47522181;598405;454;75.1;70.8;0.9;0.0
FR;2021-09-18;48192;144334;17284;24;50473975;47666515;615689;478;75.2;71.0;0.9;0.0
FR;2021-09-19;7865;24931;2619;3;50481840;47691446;618308;481;75.2;71.1;0.9;0.0
FR;2021-09-20;44448;96446;50254;55;50526288;47787892;668562;536;75.3;71.2;1.0;0.0
FR;2021-09-21;45810;98511;63369;124;50572098;47886403;731931;660;75.4;71.3;1.1;0.0
FR;2021-09-22;48588;144844;55352;68;50620686;48031247;787283;728;75.4;71.6;1.2;0.0
FR;2021-09-23;43166;91263;63477;120;50663852;48122510;850760;848;75.5;71.7;1.3;0.0
FR;2021-09-24;52223;132510;59091;103;50716075;48255020;909851;951;75.6;71.9;1.4;0.0
FR;2021-09-25;35195;118571;18254;27;50751270;48373591;928105;978;75.6;72.1;1.4;0.0
FR;2021-09-26;5524;18692;2327;5;50756794;48392283;930432;983;75.6;72.1;1.4;0.0
FR;2021-09-27;33922;78890;48128;113;50790716;48471173;978560;1096;75.7;72.2;1.5;0.0
FR;2021-09-28;36446;74401;56468;82;50827162;48545574;1035028;1178;75.7;72.3;1.5;0.0
FR;2021-09-29;44315;103032;54812;76;50871477;48648606;1089840;1254;75.8;72.5;1.6;0.0
FR;2021-09-30;36272;71415;59483;84;50907749;48720021;1149323;1338;75.9;72.6;1.7;0.0
FR;2021-10-01;61527;99710;63688;53;50969276;48819731;1213011;1391;75.9;72.7;1.8;0.0
FR;2021-10-02;39416;81693;23317;18;51008692;48901424;1236328;1409;76.0;72.9;1.8;0.0
FR;2021-10-03;5262;11294;2540;4;51013954;48912718;1238868;1413;76.0;72.9;1.8;0.0
FR;2021-10-04;34971;59574;54779;82;51048925;48972292;1293647;1495;76.1;73.0;1.9;0.0
FR;2021-10-05;33590;62200;64923;69;51082515;49034492;1358570;1564;76.1;73.1;2.0;0.0
FR;2021-10-06;42462;80240;68224;42;51124977;49114732;1426794;1606;76.2;73.2;2.1;0.0
FR;2021-10-07;30414;59484;68664;87;51155391;49174216;1495458;1693;76.2;73.3;2.2;0.0
FR;2021-10-08;48751;89902;84623;69;51204142;49264118;1580081;1762;76.3;73.4;2.4;0.0
FR;2021-10-09;33622;64136;33857;20;51237764;49328254;1613938;1782;76.3;73.5;2.4;0.0
FR;2021-10-10;4630;7935;3484;2;51242394;49336189;1617422;1784;76.4;73.5;2.4;0.0
FR;2021-10-11;30565;50651;64021;93;51272959;49386840;1681443;1877;76.4;73.6;2.5;0.0
FR;2021-10-12;31384;51422;75830;58;51304343;49438262;1757273;1935;76.4;73.7;2.6;0.0
FR;2021-10-13;39992;62828;79248;51;51344335;49501090;1836521;1986;76.5;73.8;2.7;0.0
FR;2021-10-14;30236;49755;73759;49;51374571;49550845;1910280;2035;76.5;73.8;2.8;0.0
FR;2021-10-15;44745;70468;102899;58;51419316;49621313;2013179;2093;76.6;73.9;3.0;0.0
FR;2021-10-16;31271;46727;39609;23;51450587;49668040;2052788;2116;76.7;74.0;3.1;0.0
FR;2021-10-17;3827;5694;3691;3;51454414;49673734;2056479;2119;76.7;74.0;3.1;0.0
FR;2021-10-18;28378;42678;71331;36;51482792;49716412;2127810;2155;76.7;74.1;3.2;0.0
FR;2021-10-19;27057;42322;81604;71;51509849;49758734;2209414;2226;76.7;74.1;3.3;0.0
FR;2021-10-20;35207;51876;101468;91;51545056;49810610;2310882;2317;76.8;74.2;3.4;0.0
FR;2021-10-21;25968;42016;89107;45;51571024;49852626;2399989;2362;76.8;74.3;3.6;0.0
FR;2021-10-22;38211;59338;112487;90;51609235;49911964;2512476;2452;76.9;74.4;3.7;0.0
FR;2021-10-23;26972;42460;48601;23;51636207;49954424;2561077;2475;76.9;74.4;3.8;0.0
FR;2021-10-24;2912;5021;3935;3;51639119;49959445;2565012;2478;76.9;74.4;3.8;0.0
FR;2021-10-25;25982;35638;86600;67;51665101;49995083;2651612;2545;77.0;74.5;4.0;0.0
FR;2021-10-26;23685;32304;92311;47;51688786;50027387;2743923;2592;77.0;74.5;4.1;0.0
FR;2021-10-27;30008;44209;114620;72;51718794;50071596;2858543;2664;77.1;74.6;4.3;0.0
FR;2021-10-28;23401;31203;94388;59;51742195;50102799;2952931;2723;77.1;74.7;4.4;0.0
FR;2021-10-29;31514;46548;125252;78;51773709;50149347;3078183;2801;77.1;74.7;4.6;0.0
FR;2021-10-30;20532;32870;53352;27;51794241;50182217;3131535;2828;77.2;74.8;4.7;0.0
FR;2021-10-31;2480;3869;3868;3;51796721;50186086;3135403;2831;77.2;74.8;4.7;0.0
FR;2021-11-01;8212;4960;3556;10;51804933;50191046;3138959;2841;77.2;74.8;4.7;0.0
FR;2021-11-02;25302;36353;99473;62;51830235;50227399;3238432;2903;77.2;74.8;4.8;0.0
FR;2021-11-03;29767;43603;125790;96;51860002;50271002;3364222;2999;77.3;74.9;5.0;0.0
FR;2021-11-04;23666;31641;114326;66;51883668;50302643;3478548;3065;77.3;74.9;5.2;0.0
FR;2021-11-05;32273;44711;151257;85;51915941;50347354;3629805;3150;77.4;75.0;5.4;0.0
FR;2021-11-06;21487;32458;68228;39;51937428;50379812;3698033;3189;77.4;75.1;5.5;0.0
FR;2021-11-07;2379;4053;5589;8;51939807;50383865;3703622;3197;77.4;75.1;5.5;0.0
FR;2021-11-08;20423;31083;134169;73;51960230;50414948;3837791;3270;77.4;75.1;5.7;0.0
FR;2021-11-09;22149;33098;172113;106;51982379;50448046;4009904;3376;77.5;75.2;6.0;0.0
FR;2021-11-10;31392;44285;198683;124;52013771;50492331;4208587;3500;77.5;75.2;6.3;0.0
FR;2021-11-11;4323;5867;13930;19;52018094;50498198;4222517;3519;77.5;75.2;6.3;0.0
FR;2021-11-12;28993;41877;197260;127;52047087;50540075;4419777;3646;77.5;75.3;6.6;0.0
FR;2021-11-13;20305;28355;86287;60;52067392;50568430;4506064;3706;77.6;75.3;6.7;0.0
FR;2021-11-14;2333;3408;7878;10;52069725;50571838;4513942;3716;77.6;75.4;6.7;0.0
FR;2021-11-15;20314;28063;171452;101;52090039;50599901;4685394;3817;77.6;75.4;7.0;0.0
FR;2021-11-16;23368;28007;214879;152;52113407;50627908;4900273;3969;77.6;75.4;7.3;0.0
FR;2021-11-17;30359;36701;212782;132;52143766;50664609;5113055;4101;77.7;75.5;7.6;0.0
FR;2021-11-18;23355;28890;205397;123;52167121;50693499;5318452;4224;77.7;75.5;7.9;0.0
FR;2021-11-19;33558;40086;262063;184;52200679;50733585;5580515;4408;77.8;75.6;8.3;0.0
FR;2021-11-20;25339;29400;109668;62;52226018;50762985;5690183;4470;77.8;75.6;8.5;0.0
FR;2021-11-21;2623;3483;10643;17;52228641;50766468;5700826;4487;77.8;75.6;8.5;0.0
FR;2021-11-22;22740;19179;194758;85;52251381;50785647;5895584;4572;77.9;75.7;8.8;0.0
FR;2021-11-23;25564;24453;247726;81;52276945;50810100;6143310;4653;77.9;75.7;9.2;0.0
FR;2021-11-24;31767;34771;243135;80;52308712;50844871;6386445;4733;77.9;75.8;9.5;0.0
FR;2021-11-25;25392;25200;277574;111;52334104;50870071;6664019;4844;78.0;75.8;9.9;0.0
FR;2021-11-26;33211;37579;414507;161;52367315;50907650;7078526;5005;78.0;75.9;10.5;0.0
FR;2021-11-27;23322;28654;236565;147;52390637;50936304;7315091;5152;78.1;75.9;10.9;0.0
FR;2021-11-28;3479;4126;63334;41;52394116;50940430;7378425;5193;78.1;75.9;11.0;0.0
FR;2021-11-29;19386;23454;371559;175;52413502;50963884;7749984;5368;78.1;75.9;11.5;0.0
FR;2021-11-30;24730;27243;500631;281;52438232;50991127;8250615;5649;78.1;76.0;12.3;0.0
FR;2021-12-01;26920;31876;511193;300;52465152;51023003;8761808;5949;78.2;76.0;13.1;0.0
FR;2021-12-02;21988;21389;574697;302;52487140;51044392;9336505;6251;78.2;76.1;13.9;0.0
FR;2021-12-03;25479;34146;650974;325;52512619;51078538;9987479;6576;78.2;76.1;14.9;0.0
FR;2021-12-04;18292;25910;369693;216;52530911;51104448;10357172;6792;78.3;76.1;15.4;0.0
FR;2021-12-05;4142;4957;107050;94;52535053;51109405;10464222;6886;78.3;76.2;15.6;0.0
FR;2021-12-06;23452;25744;539818;383;52558505;51135149;11004040;7269;78.3;76.2;16.4;0.0
FR;2021-12-07;23321;29174;706159;407;52581826;51164323;11710199;7676;78.3;76.2;17.4;0.0
FR;2021-12-08;25350;35467;647350;435;52607176;51199790;12357549;8111;78.4;76.3;18.4;0.0
FR;2021-12-09;24000;29498;726182;455;52631176;51229288;13083731;8566;78.4;76.3;19.5;0.0
FR;2021-12-10;27744;38327;805973;463;52658920;51267615;13889704;9029;78.5;76.4;20.7;0.0
FR;2021-12-11;20226;29949;480322;353;52679146;51297564;14370026;9382;78.5;76.4;21.4;0.0
FR;2021-12-12;5625;6469;159228;107;52684771;51304033;14529254;9489;78.5;76.4;21.6;0.0
FR;2021-12-13;21087;30181;649193;392;52705858;51334214;15178447;9881;78.5;76.5;22.6;0.0
FR;2021-12-14;27607;35869;847368;682;52733465;51370083;16025815;10563;78.6;76.5;23.9;0.0
FR;2021-12-15;28240;39947;768905;491;52761705;51410030;16794720;11054;78.6;76.6;25.0;0.0
FR;2021-12-16;27947;35626;844262;504;52789652;51445656;17638982;11558;78.7;76.7;26.3;0.0
FR;2021-12-17;31559;43776;891984;595;52821211;51489432;18530966;12153;78.7;76.7;27.6;0.0
FR;2021-12-18;24915;30259;522155;365;52846126;51519691;19053121;12518;78.7;76.8;28.4;0.0
FR;2021-12-19;8741;7966;191136;140;52854867;51527657;19244257;12658;78.8;76.8;28.7;0.0
FR;2021-12-20;31609;34260;658608;488;52886476;51561917;19902865;13146;78.8;76.8;29.7;0.0
FR;2021-12-21;39220;39254;759459;579;52925696;51601171;20662324;13725;78.9;76.9;30.8;0.0
FR;2021-12-22;39471;37502;642033;702;52965167;51638673;21304357;14427;78.9;76.9;31.7;0.0
FR;2021-12-23;33747;30403;494316;592;52998914;51669076;21798673;15019;79.0;77.0;32.5;0.0
FR;2021-12-24;10665;11629;126646;240;53009579;51680705;21925319;15259;79.0;77.0;32.7;0.0
FR;2021-12-25;769;1939;9030;72;53010348;51682644;21934349;15331;79.0;77.0;32.7;0.0
FR;2021-12-26;4697;4763;60133;169;53015045;51687407;21994482;15500;79.0;77.0;32.8;0.0
FR;2021-12-27;30416;33172;509091;673;53045461;51720579;22503573;16173;79.0;77.1;33.5;0.0
FR;2021-12-28;38318;35340;632176;1555;53083779;51755919;23135749;17728;79.1;77.1;34.5;0.0
FR;2021-12-29;39846;33288;560924;1753;53123625;51789207;23696673;19481;79.2;77.2;35.3;0.0
FR;2021-12-30;35892;29480;471098;1880;53159517;51818687;24167771;21361;79.2;77.2;36.0;0.0
FR;2021-12-31;12038;11355;131619;755;53171555;51830042;24299390;22116;79.2;77.2;36.2;0.0
FR;2022-01-01;1378;1771;9929;100;53172933;51831813;24309319;22216;79.2;77.2;36.2;0.0
FR;2022-01-02;6076;5086;66937;408;53179009;51836899;24376256;22624;79.2;77.2;36.3;0.0
FR;2022-01-03;32947;36679;551493;2643;53211956;51873578;24927749;25267;79.3;77.3;37.1;0.0
FR;2022-01-04;40992;40540;714223;3839;53252948;51914118;25641972;29106;79.3;77.4;38.2;0.0
FR;2022-01-05;60415;43475;634069;3436;53313363;51957593;26276041;32542;79.4;77.4;39.2;0.0
FR;2022-01-06;44005;40072;711313;4566;53357368;51997665;26987354;37108;79.5;77.5;40.2;0.1
FR;2022-01-07;50617;46624;790345;5003;53407985;52044289;27777699;42111;79.6;77.5;41.4;0.1
FR;2022-01-08;44958;35028;472846;2444;53452943;52079317;28250545;44555;79.6;77.6;42.1;0.1
FR;2022-01-09;15595;11490;145696;830;53468538;52090807;28396241;45385;79.7;77.6;42.3;0.1
FR;2022-01-10;35057;39010;522212;3720;53503595;52129817;28918453;49105;79.7;77.7;43.1;0.1
FR;2022-01-11;41657;42170;608394;5214;53545252;52171987;29526847;54319;79.8;77.7;44.0;0.1
FR;2022-01-12;60181;49276;504228;4492;53605433;52221263;30031075;58811;79.9;77.8;44.7;0.1
FR;2022-01-13;37937;40347;540958;5461;53643370;52261610;30572033;64272;79.9;77.9;45.6;0.1
FR;2022-01-14;42407;43360;628954;6460;53685777;52304970;31200987;70732;80.0;77.9;46.5;0.1
FR;2022-01-15;39306;31324;377543;3293;53725083;52336294;31578530;74025;80.0;78.0;47.1;0.1
FR;2022-01-16;11382;9016;99447;760;53736465;52345310;31677977;74785;80.1;78.0;47.2;0.1
FR;2022-01-17;24621;28048;354122;3961;53761086;52373358;32032099;78746;80.1;78.0;47.7;0.1
FR;2022-01-18;28106;31829;397508;5772;53789192;52405187;32429607;84518;80.1;78.1;48.3;0.1
FR;2022-01-19;43056;40316;311058;4385;53832248;52445503;32740665;88903;80.2;78.1;48.8;0.1
FR;2022-01-20;23424;29364;328419;5626;53855672;52474867;33069084;94529;80.2;78.2;49.3;0.1
FR;2022-01-21;28024;32984;401122;6582;53883696;52507851;33470206;101111;80.3;78.2;49.9;0.2
FR;2022-01-22;27607;27224;241742;2842;53911303;52535075;33711948;103953;80.3;78.3;50.2;0.2
FR;2022-01-23;6704;7511;55178;590;53918007;52542586;33767126;104543;80.3;78.3;50.3;0.2
FR;2022-01-24;16204;25144;239314;4095;53934211;52567730;34006440;108638;80.4;78.3;50.7;0.2
FR;2022-01-25;18911;28648;267036;6064;53953122;52596378;34273476;114702;80.4;78.4;51.1;0.2
FR;2022-01-26;28112;41069;229352;4474;53981234;52637447;34502828;119176;80.4;78.4;51.4;0.2
FR;2022-01-27;16277;25809;225822;5695;53997511;52663256;34728650;124871;80.5;78.5;51.7;0.2
FR;2022-01-28;21499;41899;321444;7412;54019010;52705155;35050094;132283;80.5;78.5;52.2;0.2
FR;2022-01-29;18402;32676;204572;3249;54037412;52737831;35254666;135532;80.5;78.6;52.5;0.2
FR;2022-01-30;4463;9148;45088;639;54041875;52746979;35299754;136171;80.5;78.6;52.6;0.2
FR;2022-01-31;11222;25969;164784;4242;54053097;52772948;35464538;140413;80.5;78.6;52.8;0.2
FR;2022-02-01;12824;27121;191367;7101;54065921;52800069;35655905;147514;80.6;78.7;53.1;0.2
FR;2022-02-02;20100;45695;190123;5993;54086021;52845764;35846028;153507;80.6;78.7;53.4;0.2
FR;2022-02-03;10991;24653;173298;6968;54097012;52870417;36019326;160475;80.6;78.8;53.7;0.2
FR;2022-02-04;14503;35957;264166;9206;54111515;52906374;36283492;169681;80.6;78.8;54.1;0.3
FR;2022-02-05;12786;31924;172338;3817;54124301;52938298;36455830;173498;80.6;78.9;54.3;0.3
FR;2022-02-06;2705;7320;33827;664;54127006;52945618;36489657;174162;80.6;78.9;54.4;0.3
FR;2022-02-07;9388;24432;176315;5289;54136394;52970050;36665972;179451;80.7;78.9;54.6;0.3
FR;2022-02-08;9605;20564;184325;7050;54145999;52990614;36850297;186501;80.7;79.0;54.9;0.3
FR;2022-02-09;14173;35015;192965;5779;54160172;53025629;37043262;192280;80.7;79.0;55.2;0.3
FR;2022-02-10;8272;17921;166592;6497;54168444;53043550;37209854;198777;80.7;79.0;55.4;0.3
FR;2022-02-11;10762;25641;243011;8324;54179206;53069191;37452865;207101;80.7;79.1;55.8;0.3
FR;2022-02-12;8350;22557;151707;3502;54187556;53091748;37604572;210603;80.7;79.1;56.0;0.3
FR;2022-02-13;1895;4390;30905;543;54189451;53096138;37635477;211146;80.7;79.1;56.1;0.3
FR;2022-02-14;6911;14512;166309;4774;54196362;53110650;37801786;215920;80.8;79.1;56.3;0.3
FR;2022-02-15;6858;15280;162445;6846;54203220;53125930;37964231;222766;80.8;79.2;56.6;0.3
FR;2022-02-16;9294;25651;146661;5721;54212514;53151581;38110892;228487;80.8;79.2;56.8;0.3
FR;2022-02-17;5375;12648;94779;5403;54217889;53164229;38205671;233890;80.8;79.2;56.9;0.3
FR;2022-02-18;6888;18457;129257;7399;54224777;53182686;38334928;241289;80.8;79.2;57.1;0.4
FR;2022-02-19;5350;15806;77303;3016;54230127;53198492;38412231;244305;80.8;79.3;57.2;0.4
FR;2022-02-20;1139;2884;13926;459;54231266;53201376;38426157;244764;80.8;79.3;57.3;0.4
FR;2022-02-21;4025;10047;67139;4057;54235291;53211423;38493296;248821;80.8;79.3;57.4;0.4
FR;2022-02-22;4374;11107;64411;5249;54239665;53222530;38557707;254070;80.8;79.3;57.5;0.4
FR;2022-02-23;6516;19404;71861;4591;54246181;53241934;38629568;258661;80.8;79.3;57.6;0.4
FR;2022-02-24;3745;9137;53185;4530;54249926;53251071;38682753;263191;80.8;79.3;57.6;0.4
FR;2022-02-25;5206;14550;80004;7327;54255132;53265621;38762757;270518;80.8;79.4;57.8;0.4
FR;2022-02-26;3970;12041;51459;3083;54259102;53277662;38814216;273601;80.8;79.4;57.8;0.4
FR;2022-02-27;870;1957;8933;529;54259972;53279619;38823149;274130;80.8;79.4;57.8;0.4
FR;2022-02-28;3069;7304;42882;3850;54263041;53286923;38866031;277980;80.9;79.4;57.9;0.4
FR;2022-03-01;3145;7295;44767;5511;54266186;53294218;38910798;283491;80.9;79.4;58.0;0.4
FR;2022-03-02;5087;12540;48996;4920;54271273;53306758;38959794;288411;80.9;79.4;58.0;0.4
FR;2022-03-03;2660;5846;29923;4044;54273933;53312604;38989717;292455;80.9;79.4;58.1;0.4
FR;2022-03-04;3183;8200;39389;6211;54277116;53320804;39029106;298666;80.9;79.4;58.2;0.4
FR;2022-03-05;2939;7061;25079;3130;54280055;53327865;39054185;301796;80.9;79.5;58.2;0.4
FR;2022-03-06;510;1011;3431;378;54280565;53328876;39057616;302174;80.9;79.5;58.2;0.5
FR;2022-03-07;1966;3706;17655;3298;54282531;53332582;39075271;305472;80.9;79.5;58.2;0.5
FR;2022-03-08;1971;4152;17864;4088;54284502;53336734;39093135;309560;80.9;79.5;58.2;0.5
FR;2022-03-09;3455;8523;21226;4030;54287957;53345257;39114361;313590;80.9;79.5;58.3;0.5
FR;2022-03-10;1714;3819;15694;3394;54289671;53349076;39130055;316984;80.9;79.5;58.3;0.5
FR;2022-03-11;2343;5185;22225;5470;54292014;53354261;39152280;322454;80.9;79.5;58.3;0.5
FR;2022-03-12;2656;5434;16499;3132;54294670;53359695;39168779;325586;80.9;79.5;58.4;0.5
FR;2022-03-13;386;589;2255;529;54295056;53360284;39171034;326115;80.9;79.5;58.4;0.5
FR;2022-03-14;1471;2688;13790;7280;54296527;53362972;39184824;333395;80.9;79.5;58.4;0.5
FR;2022-03-15;1596;3013;14334;11013;54298123;53365985;39199158;344408;80.9;79.5;58.4;0.5
FR;2022-03-16;2944;5871;18028;16285;54301067;53371856;39217186;360693;80.9;79.5;58.4;0.5
FR;2022-03-17;1371;2519;11936;13294;54302438;53374375;39229122;373987;80.9;79.5;58.5;0.6
FR;2022-03-18;2201;3878;18033;22014;54304639;53378253;39247155;396001;80.9;79.5;58.5;0.6
FR;2022-03-19;2277;4016;12404;11403;54306916;53382269;39259559;407404;80.9;79.5;58.5;0.6
FR;2022-03-20;293;504;1918;1332;54307209;53382773;39261477;408736;80.9;79.5;58.5;0.6
FR;2022-03-21;1342;2069;11911;16900;54308551;53384842;39273388;425636;80.9;79.5;58.5;0.6
FR;2022-03-22;1462;2430;12512;22812;54310013;53387272;39285900;448448;80.9;79.5;58.5;0.7
FR;2022-03-23;2640;5028;17158;25243;54312653;53392300;39303058;473691;80.9;79.6;58.6;0.7
FR;2022-03-24;1355;2016;10622;19352;54314008;53394316;39313680;493043;80.9;79.6;58.6;0.7
FR;2022-03-25;2047;3343;16828;30777;54316055;53397659;39330508;523820;80.9;79.6;58.6;0.8
FR;2022-03-26;2216;3712;11498;14378;54318271;53401371;39342006;538198;80.9;79.6;58.6;0.8
FR;2022-03-27;354;501;1915;1733;54318625;53401872;39343921;539931;80.9;79.6;58.6;0.8
FR;2022-03-28;1412;1972;10565;19026;54320037;53403844;39354486;558957;80.9;79.6;58.6;0.8
FR;2022-03-29;1421;2031;12013;29229;54321458;53405875;39366499;588186;80.9;79.6;58.7;0.9
FR;2022-03-30;2810;4548;15015;29250;54324268;53410423;39381514;617436;80.9;79.6;58.7;0.9
FR;2022-03-31;1590;2130;12201;26493;54325858;53412553;39393715;643929;80.9;79.6;58.7;1.0
FR;2022-04-01;2089;2664;18596;33409;54327947;53415217;39412311;677338;80.9;79.6;58.7;1.0
FR;2022-04-02;1493;1968;8690;11267;54329440;53417185;39421001;688605;80.9;79.6;58.7;1.0
FR;2022-04-03;274;340;1571;1379;54329714;53417525;39422572;689984;81.0;79.6;58.7;1.0
FR;2022-04-04;1340;1576;11452;20538;54331054;53419101;39434024;710522;81.0;79.6;58.8;1.1
FR;2022-04-05;1590;1803;13094;35591;54332644;53420904;39447118;746113;81.0;79.6;58.8;1.1
FR;2022-04-06;2031;2697;12669;27793;54334675;53423601;39459787;773906;81.0;79.6;58.8;1.2
FR;2022-04-07;1425;1702;12783;34969;54336100;53425303;39472570;808875;81.0;79.6;58.8;1.2
FR;2022-04-08;2013;2404;17742;46002;54338113;53427707;39490312;854877;81.0;79.6;58.8;1.3
FR;2022-04-09;1346;1872;8835;14773;54339459;53429579;39499147;869650;81.0;79.6;58.9;1.3
FR;2022-04-10;276;368;1972;2254;54339735;53429947;39501119;871904;81.0;79.6;58.9;1.3
FR;2022-04-11;1182;1478;11414;24907;54340917;53431425;39512533;896811;81.0;79.6;58.9;1.3
FR;2022-04-12;1563;1654;13284;41454;54342480;53433079;39525817;938265;81.0;79.6;58.9;1.4
FR;2022-04-13;1844;2413;12900;33757;54344324;53435492;39538717;972022;81.0;79.6;58.9;1.4
FR;2022-04-14;1435;1592;12882;36609;54345759;53437084;39551599;1008631;81.0;79.6;58.9;1.5
FR;2022-04-15;1775;2065;14740;36891;54347534;53439149;39566339;1045522;81.0;79.6;59.0;1.6
FR;2022-04-16;1029;1235;6219;9408;54348563;53440384;39572558;1054930;81.0;79.6;59.0;1.6
FR;2022-04-17;183;200;1028;1225;54348746;53440584;39573586;1056155;81.0;79.6;59.0;1.6
FR;2022-04-18;145;237;2750;1249;54348891;53440821;39576336;1057404;81.0;79.6;59.0;1.6
FR;2022-04-19;1463;1745;12342;30474;54350354;53442566;39588678;1087878;81.0;79.6;59.0;1.6
FR;2022-04-20;1896;2430;12843;29803;54352250;53444996;39601521;1117681;81.0;79.6;59.0;1.7
FR;2022-04-21;1469;1693;12431;35341;54353719;53446689;39613952;1153022;81.0;79.6;59.0;1.7
FR;2022-04-22;1817;2219;15762;38939;54355536;53448908;39629714;1191961;81.0;79.6;59.0;1.8
FR;2022-04-23;1121;1441;7201;11421;54356657;53450349;39636915;1203382;81.0;79.6;59.1;1.8
FR;2022-04-24;237;304;1402;1835;54356894;53450653;39638317;1205217;81.0;79.6;59.1;1.8
FR;2022-04-25;1250;1513;10421;21886;54358144;53452166;39648738;1227103;81.0;79.6;59.1;1.8
FR;2022-04-26;1561;1883;13010;39024;54359705;53454049;39661748;1266127;81.0;79.6;59.1;1.9
FR;2022-04-27;1904;2201;11486;31004;54361609;53456250;39673234;1297131;81.0;79.6;59.1;1.9
FR;2022-04-28;1517;1707;12134;36025;54363126;53457957;39685368;1333156;81.0;79.7;59.1;2.0
FR;2022-04-29;1947;2224;14732;38311;54365073;53460181;39700100;1371467;81.0;79.7;59.2;2.0
FR;2022-04-30;1179;1274;6629;10539;54366252;53461455;39706729;1382006;81.0;79.7;59.2;2.1
FR;2022-05-01;184;203;880;1092;54366436;53461658;39707609;1383098;81.0;79.7;59.2;2.1
FR;2022-05-02;1139;1262;10666;18689;54367575;53462920;39718275;1401787;81.0;79.7;59.2;2.1
FR;2022-05-03;1705;1723;13190;35035;54369280;53464643;39731465;1436822;81.0;79.7;59.2;2.1
FR;2022-05-04;1796;1927;11808;25777;54371076;53466570;39743273;1462599;81.0;79.7;59.2;2.2
FR;2022-05-05;1592;1636;11963;33652;54372668;53468206;39755236;1496251;81.0;79.7;59.2;2.2
FR;2022-05-06;2032;2166;14558;37878;54374700;53470372;39769794;1534129;81.0;79.7;59.3;2.3
FR;2022-05-07;1165;1227;6366;10279;54375865;53471599;39776160;1544408;81.0;79.7;59.3;2.3
FR;2022-05-08;253;274;1206;1626;54376118;53471873;39777366;1546034;81.0;79.7;59.3;2.3
FR;2022-05-09;1231;1212;9579;20852;54377349;53473085;39786945;1566886;81.0;79.7;59.3;2.3
FR;2022-05-10;1613;1703;12662;39301;54378962;53474788;39799607;1606187;81.0;79.7;59.3;2.4
FR;2022-05-11;1906;1987;10334;28070;54380868;53476775;39809941;1634257;81.0;79.7;59.3;2.4
FR;2022-05-12;1494;1535;10640;35855;54382362;53478310;39820581;1670112;81.0;79.7;59.3;2.5
FR;2022-05-13;1902;1916;13109;38534;54384264;53480226;39833690;1708646;81.0;79.7;59.4;2.5
FR;2022-05-14;1113;1113;5560;11253;54385377;53481339;39839250;1719899;81.0;79.7;59.4;2.6
FR;2022-05-15;260;237;1308;1567;54385637;53481576;39840558;1721466;81.0;79.7;59.4;2.6
FR;2022-05-16;1120;1083;8026;21116;54386757;53482659;39848584;1742582;81.0;79.7;59.4;2.6
FR;2022-05-17;1511;1487;10663;37933;54388268;53484146;39859247;1780515;81.0;79.7;59.4;2.7
FR;2022-05-18;1714;1766;8801;27263;54389982;53485912;39868048;1807778;81.0;79.7;59.4;2.7
FR;2022-05-19;1367;1448;9775;34960;54391349;53487360;39877823;1842738;81.0;79.7;59.4;2.7
FR;2022-05-20;1807;1874;11816;39662;54393156;53489234;39889639;1882400;81.0;79.7;59.4;2.8
FR;2022-05-21;1126;1240;5017;10279;54394282;53490474;39894656;1892679;81.0;79.7;59.4;2.8
FR;2022-05-22;222;238;973;1481;54394504;53490712;39895629;1894160;81.0;79.7;59.4;2.8
FR;2022-05-23;1076;1177;7292;20354;54395580;53491889;39902921;1914514;81.0;79.7;59.5;2.9
FR;2022-05-24;1457;1560;10080;38119;54397037;53493449;39913001;1952633;81.1;79.7;59.5;2.9
FR;2022-05-25;1734;1875;8620;24660;54398771;53495324;39921621;1977293;81.1;79.7;59.5;2.9
FR;2022-05-26;163;144;824;1116;54398934;53495468;39922445;1978409;81.1;79.7;59.5;2.9
FR;2022-05-27;1290;1439;7834;21835;54400224;53496907;39930279;2000244;81.1;79.7;59.5;3.0
FR;2022-05-28;625;765;3566;7080;54400849;53497672;39933845;2007324;81.1;79.7;59.5;3.0
FR;2022-05-29;137;178;705;954;54400986;53497850;39934550;2008278;81.1;79.7;59.5;3.0
FR;2022-05-30;949;1089;6083;19057;54401935;53498939;39940633;2027335;81.1;79.7;59.5;3.0
FR;2022-05-31;1388;1394;8987;34669;54403323;53500333;39949620;2062004;81.1;79.7;59.5;3.1
FR;2022-06-01;1427;1611;7153;23508;54404750;53501944;39956773;2085512;81.1;79.7;59.5;3.1
