fra;jour;n_dose1;n_complet;n_rappel;n_2_rappel;n_cum_dose1;n_cum_complet;n_cum_rappel;n_cum_2_rappel;couv_dose1;couv_complet;couv_rappel;couv_2_rappel
FR;2020-12-27;602;55;0;0;602;55;0;0;0.0;0.0;0.0;0.0
FR;2020-12-28;665;42;0;0;1267;97;0;0;0.0;0.0;0.0;0.0
FR;2020-12-29;373;19;0;0;1640;116;0;0;0.0;0.0;0.0;0.0
FR;2020-12-30;439;18;0;0;2079;134;0;0;0.0;0.0;0.0;0.0
FR;2020-12-31;415;22;0;0;2494;156;0;0;0.0;0.0;0.0;0.0
FR;2021-01-01;1135;64;0;0;3629;220;0;0;0.0;0.0;0.0;0.0
FR;2021-01-02;356;30;0;0;3985;250;0;0;0.0;0.0;0.0;0.0
FR;2021-01-03;400;27;0;0;4385;277;0;0;0.0;0.0;0.0;0.0
FR;2021-01-04;2087;48;0;0;6472;325;0;0;0.0;0.0;0.0;0.0
FR;2021-01-05;7564;123;0;0;14036;448;0;0;0.0;0.0;0.0;0.0
FR;2021-01-06;12414;119;0;0;26450;567;0;0;0.0;0.0;0.0;0.0
FR;2021-01-07;29446;157;0;0;55896;724;0;0;0.1;0.0;0.0;0.0
FR;2021-01-08;37121;195;0;0;93017;919;0;0;0.1;0.0;0.0;0.0
FR;2021-01-09;11209;75;0;0;104226;994;0;0;0.2;0.0;0.0;0.0
FR;2021-01-10;5996;24;0;0;110222;1018;0;0;0.2;0.0;0.0;0.0
FR;2021-01-11;39923;226;0;0;150145;1244;0;0;0.2;0.0;0.0;0.0
FR;2021-01-12;62120;310;0;0;212265;1554;0;0;0.3;0.0;0.0;0.0
FR;2021-01-13;65096;431;0;0;277361;1985;0;0;0.4;0.0;0.0;0.0
FR;2021-01-14;83123;1189;0;0;360484;3174;0;0;0.5;0.0;0.0;0.0
FR;2021-01-15;68988;561;0;0;429472;3735;0;0;0.6;0.0;0.0;0.0
FR;2021-01-16;20208;189;0;0;449680;3924;0;0;0.7;0.0;0.0;0.0
FR;2021-01-17;10976;131;0;0;460656;4055;0;0;0.7;0.0;0.0;0.0
FR;2021-01-18;85879;612;0;0;546535;4667;0;0;0.8;0.0;0.0;0.0
FR;2021-01-19;130572;864;0;0;677107;5531;0;0;1.0;0.0;0.0;0.0
FR;2021-01-20;137524;853;0;0;814631;6384;0;0;1.2;0.0;0.0;0.0
FR;2021-01-21;158371;968;0;0;973002;7352;0;0;1.4;0.0;0.0;0.0
FR;2021-01-22;121038;833;0;0;1094040;8185;0;0;1.6;0.0;0.0;0.0
FR;2021-01-23;38464;203;0;0;1132504;8388;0;0;1.7;0.0;0.0;0.0
FR;2021-01-24;9740;134;0;0;1142244;8522;0;0;1.7;0.0;0.0;0.0
FR;2021-01-25;78217;1629;0;0;1220461;10151;0;0;1.8;0.0;0.0;0.0
FR;2021-01-26;100359;3762;0;0;1320820;13913;0;0;2.0;0.0;0.0;0.0
FR;2021-01-27;107223;6646;0;0;1428043;20559;0;0;2.1;0.0;0.0;0.0
FR;2021-01-28;124324;15783;0;0;1552367;36342;0;0;2.3;0.1;0.0;0.0
FR;2021-01-29;92169;18248;0;0;1644536;54590;0;0;2.5;0.1;0.0;0.0
FR;2021-01-30;29111;4375;0;0;1673647;58965;0;0;2.5;0.1;0.0;0.0
FR;2021-01-31;5225;1769;0;0;1678872;60734;0;0;2.5;0.1;0.0;0.0
FR;2021-02-01;53103;21741;0;0;1731975;82475;0;0;2.6;0.1;0.0;0.0
FR;2021-02-02;72275;36106;0;0;1804250;118581;0;0;2.7;0.2;0.0;0.0
FR;2021-02-03;72287;38352;0;0;1876537;156933;0;0;2.8;0.2;0.0;0.0
FR;2021-02-04;82047;52015;0;0;1958584;208948;0;0;2.9;0.3;0.0;0.0
FR;2021-02-05;68215;46480;0;0;2026799;255428;0;0;3.0;0.4;0.0;0.0
FR;2021-02-06;23109;10965;0;0;2049908;266393;0;0;3.1;0.4;0.0;0.0
FR;2021-02-07;5182;5362;0;0;2055090;271755;0;0;3.1;0.4;0.0;0.0
FR;2021-02-08;46815;47245;0;0;2101905;319000;0;0;3.1;0.5;0.0;0.0
FR;2021-02-09;65990;75326;0;0;2167895;394326;0;0;3.2;0.6;0.0;0.0
FR;2021-02-10;70984;80379;0;0;2238879;474705;0;0;3.3;0.7;0.0;0.0
FR;2021-02-11;87237;102792;0;0;2326116;577497;0;0;3.5;0.9;0.0;0.0
FR;2021-02-12;79288;76494;0;0;2405404;653991;0;0;3.6;1.0;0.0;0.0
FR;2021-02-13;22351;19782;0;0;2427755;673773;0;0;3.6;1.0;0.0;0.0
FR;2021-02-14;5071;7298;0;0;2432826;681071;0;0;3.6;1.0;0.0;0.0
FR;2021-02-15;38068;77382;0;0;2470894;758453;0;0;3.7;1.1;0.0;0.0
FR;2021-02-16;50363;101666;0;0;2521257;860119;0;0;3.8;1.3;0.0;0.0
FR;2021-02-17;50498;105768;0;0;2571755;965887;0;0;3.8;1.4;0.0;0.0
FR;2021-02-18;69755;122111;0;0;2641510;1087998;0;0;3.9;1.6;0.0;0.0
FR;2021-02-19;65048;92681;0;0;2706558;1180679;0;0;4.0;1.8;0.0;0.0
FR;2021-02-20;18573;28846;0;0;2725131;1209525;0;0;4.1;1.8;0.0;0.0
FR;2021-02-21;3314;6404;0;0;2728445;1215929;0;0;4.1;1.8;0.0;0.0
FR;2021-02-22;37476;73943;0;0;2765921;1289872;0;0;4.1;1.9;0.0;0.0
FR;2021-02-23;53759;85773;0;0;2819680;1375645;0;0;4.2;2.0;0.0;0.0
FR;2021-02-24;59979;83150;0;0;2879659;1458795;0;0;4.3;2.2;0.0;0.0
FR;2021-02-25;100542;94267;0;0;2980201;1553062;0;0;4.4;2.3;0.0;0.0
FR;2021-02-26;113429;73744;0;0;3093630;1626806;0;0;4.6;2.4;0.0;0.0
FR;2021-02-27;52091;23353;0;0;3145721;1650159;0;0;4.7;2.5;0.0;0.0
FR;2021-02-28;6190;4480;0;0;3151911;1654639;0;0;4.7;2.5;0.0;0.0
FR;2021-03-01;65830;55064;0;0;3217741;1709703;0;0;4.8;2.5;0.0;0.0
FR;2021-03-02;101345;69504;0;0;3319086;1779207;0;0;4.9;2.7;0.0;0.0
FR;2021-03-03;116463;69082;0;0;3435549;1848289;0;0;5.1;2.8;0.0;0.0
FR;2021-03-04;163582;75663;0;0;3599131;1923952;0;0;5.4;2.9;0.0;0.0
FR;2021-03-05;200882;69767;0;0;3800013;1993719;0;0;5.7;3.0;0.0;0.0
FR;2021-03-06;207925;23030;0;0;4007938;2016749;0;0;6.0;3.0;0.0;0.0
FR;2021-03-07;121250;8303;0;0;4129188;2025052;0;0;6.2;3.0;0.0;0.0
FR;2021-03-08;107111;53784;0;0;4236299;2078836;0;0;6.3;3.1;0.0;0.0
FR;2021-03-09;172409;61888;0;0;4408708;2140724;0;0;6.6;3.2;0.0;0.0
FR;2021-03-10;178936;62716;0;0;4587644;2203440;0;0;6.8;3.3;0.0;0.0
FR;2021-03-11;242823;71465;0;0;4830467;2274905;0;0;7.2;3.4;0.0;0.0
FR;2021-03-12;294773;62810;0;0;5125240;2337715;0;0;7.6;3.5;0.0;0.0
FR;2021-03-13;231370;21302;0;0;5356610;2359017;0;0;8.0;3.5;0.0;0.0
FR;2021-03-14;63334;5336;0;0;5419944;2364353;0;0;8.1;3.5;0.0;0.0
FR;2021-03-15;158601;36792;0;0;5578545;2401145;0;0;8.3;3.6;0.0;0.0
FR;2021-03-16;141538;43234;0;0;5720083;2444379;0;0;8.5;3.6;0.0;0.0
FR;2021-03-17;150446;42929;0;0;5870529;2487308;0;0;8.7;3.7;0.0;0.0
FR;2021-03-18;167779;50025;0;0;6038308;2537333;0;0;9.0;3.8;0.0;0.0
FR;2021-03-19;229961;44513;0;0;6268269;2581846;0;0;9.3;3.8;0.0;0.0
FR;2021-03-20;166639;16219;0;0;6434908;2598065;0;0;9.6;3.9;0.0;0.0
FR;2021-03-21;49918;4278;0;0;6484826;2602343;0;0;9.7;3.9;0.0;0.0
FR;2021-03-22;169993;39435;0;0;6654819;2641778;0;0;9.9;3.9;0.0;0.0
FR;2021-03-23;250329;50163;0;0;6905148;2691941;0;0;10.3;4.0;0.0;0.0
FR;2021-03-24;256848;51730;0;0;7161996;2743671;0;0;10.7;4.1;0.0;0.0
FR;2021-03-25;341745;55790;0;0;7503741;2799461;0;0;11.2;4.2;0.0;0.0
FR;2021-03-26;358745;53566;0;0;7862486;2853027;0;0;11.7;4.3;0.0;0.0
FR;2021-03-27;195238;23144;0;0;8057724;2876171;0;0;12.0;4.3;0.0;0.0
FR;2021-03-28;59321;6062;0;0;8117045;2882233;0;0;12.1;4.3;0.0;0.0
FR;2021-03-29;202927;60687;0;0;8319972;2942920;0;0;12.4;4.4;0.0;0.0
FR;2021-03-30;285406;79976;0;0;8605378;3022896;0;0;12.8;4.5;0.0;0.0
FR;2021-03-31;262961;83825;0;0;8868339;3106721;0;0;13.2;4.6;0.0;0.0
FR;2021-04-01;315380;102666;0;0;9183719;3209387;0;0;13.7;4.8;0.0;0.0
FR;2021-04-02;281276;104478;0;0;9464995;3313865;0;0;14.1;4.9;0.0;0.0
FR;2021-04-03;141048;67128;0;0;9606043;3380993;0;0;14.3;5.0;0.0;0.0
FR;2021-04-04;46449;20772;0;0;9652492;3401765;0;0;14.4;5.1;0.0;0.0
FR;2021-04-05;63304;13451;0;0;9715796;3415216;0;0;14.5;5.1;0.0;0.0
FR;2021-04-06;217140;117903;0;0;9932936;3533119;0;0;14.8;5.3;0.0;0.0
FR;2021-04-07;260188;126603;0;0;10193124;3659722;0;0;15.2;5.5;0.0;0.0
FR;2021-04-08;337732;137191;0;0;10530856;3796913;0;0;15.7;5.7;0.0;0.0
FR;2021-04-09;410079;133594;0;0;10940935;3930507;0;0;16.3;5.9;0.0;0.0
FR;2021-04-10;212581;90971;0;0;11153516;4021478;0;0;16.6;6.0;0.0;0.0
FR;2021-04-11;56122;36942;0;0;11209638;4058420;0;0;16.7;6.0;0.0;0.0
FR;2021-04-12;236997;124718;0;0;11446635;4183138;0;0;17.1;6.2;0.0;0.0
FR;2021-04-13;309416;157345;0;0;11756051;4340483;0;0;17.5;6.5;0.0;0.0
FR;2021-04-14;294431;152561;0;0;12050482;4493044;0;0;18.0;6.7;0.0;0.0
FR;2021-04-15;337006;163763;0;0;12387488;4656807;0;0;18.5;6.9;0.0;0.0
FR;2021-04-16;339222;160449;0;0;12726710;4817256;0;0;19.0;7.2;0.0;0.0
FR;2021-04-17;188621;97663;0;0;12915331;4914919;0;0;19.2;7.3;0.0;0.0
FR;2021-04-18;51601;37782;0;0;12966932;4952701;0;0;19.3;7.4;0.0;0.0
FR;2021-04-19;205639;147255;0;0;13172571;5099956;0;0;19.6;7.6;0.0;0.0
FR;2021-04-20;254343;182370;0;0;13426914;5282326;0;0;20.0;7.9;0.0;0.0
FR;2021-04-21;253176;180992;0;0;13680090;5463318;0;0;20.4;8.1;0.0;0.0
FR;2021-04-22;287486;203211;0;0;13967576;5666529;0;0;20.8;8.4;0.0;0.0
FR;2021-04-23;297928;202427;0;0;14265504;5868956;0;0;21.3;8.7;0.0;0.0
FR;2021-04-24;190407;121953;0;0;14455911;5990909;0;0;21.5;8.9;0.0;0.0
FR;2021-04-25;69537;42493;0;0;14525448;6033402;0;0;21.6;9.0;0.0;0.0
FR;2021-04-26;220889;169378;0;0;14746337;6202780;0;0;22.0;9.2;0.0;0.0
FR;2021-04-27;284544;210551;0;0;15030881;6413331;0;0;22.4;9.6;0.0;0.0
FR;2021-04-28;299434;208240;1;0;15330315;6621571;1;0;22.8;9.9;0.0;0.0
FR;2021-04-29;357052;231498;0;0;15687367;6853069;1;0;23.4;10.2;0.0;0.0
FR;2021-04-30;372130;224070;0;0;16059497;7077139;1;0;23.9;10.5;0.0;0.0
FR;2021-05-01;167597;63721;0;0;16227094;7140860;1;0;24.2;10.6;0.0;0.0
FR;2021-05-02;91706;43451;0;0;16318800;7184311;1;0;24.3;10.7;0.0;0.0
FR;2021-05-03;288853;188920;0;0;16607653;7373231;1;0;24.7;11.0;0.0;0.0
FR;2021-05-04;315588;250437;0;0;16923241;7623668;1;0;25.2;11.4;0.0;0.0
FR;2021-05-05;327093;249709;0;0;17250334;7873377;1;0;25.7;11.7;0.0;0.0
FR;2021-05-06;379419;273582;0;0;17629753;8146959;1;0;26.3;12.1;0.0;0.0
FR;2021-05-07;372678;298244;0;0;18002431;8445203;1;0;26.8;12.6;0.0;0.0
FR;2021-05-08;222134;82519;0;0;18224565;8527722;1;0;27.2;12.7;0.0;0.0
FR;2021-05-09;129684;55025;0;0;18354249;8582747;1;0;27.3;12.8;0.0;0.0
FR;2021-05-10;313294;254395;0;0;18667543;8837142;1;0;27.8;13.2;0.0;0.0
FR;2021-05-11;403814;296181;0;0;19071357;9133323;1;0;28.4;13.6;0.0;0.0
FR;2021-05-12;434024;269221;0;0;19505381;9402544;1;0;29.1;14.0;0.0;0.0
FR;2021-05-13;338545;78404;0;0;19843926;9480948;1;0;29.6;14.1;0.0;0.0
FR;2021-05-14;454051;202754;0;0;20297977;9683702;1;0;30.2;14.4;0.0;0.0
FR;2021-05-15;374917;120383;0;0;20672894;9804085;1;0;30.8;14.6;0.0;0.0
FR;2021-05-16;202718;34173;0;0;20875612;9838258;1;0;31.1;14.7;0.0;0.0
FR;2021-05-17;376061;178562;0;0;21251673;10016820;1;0;31.7;14.9;0.0;0.0
FR;2021-05-18;460055;192198;0;0;21711728;10209018;1;0;32.4;15.2;0.0;0.0
FR;2021-05-19;467316;181997;0;0;22179044;10391015;1;0;33.0;15.5;0.0;0.0
FR;2021-05-20;507453;204136;0;0;22686497;10595151;1;0;33.8;15.8;0.0;0.0
FR;2021-05-21;489588;220841;0;0;23176085;10815992;1;0;34.5;16.1;0.0;0.0
FR;2021-05-22;347138;108267;0;0;23523223;10924259;1;0;35.0;16.3;0.0;0.0
FR;2021-05-23;161658;26875;0;0;23684881;10951134;1;0;35.3;16.3;0.0;0.0
FR;2021-05-24;263130;53019;0;0;23948011;11004153;1;0;35.7;16.4;0.0;0.0
FR;2021-05-25;400141;225629;0;0;24348152;11229782;1;0;36.3;16.7;0.0;0.0
FR;2021-05-26;413359;226438;0;0;24761511;11456220;1;0;36.9;17.1;0.0;0.0
FR;2021-05-27;449694;265635;0;0;25211205;11721855;1;0;37.6;17.5;0.0;0.0
FR;2021-05-28;429442;317393;0;0;25640647;12039248;1;0;38.2;17.9;0.0;0.0
FR;2021-05-29;298942;182144;0;0;25939589;12221392;1;0;38.6;18.2;0.0;0.0
FR;2021-05-30;107096;42160;0;0;26046685;12263552;1;0;38.8;18.3;0.0;0.0
FR;2021-05-31;357917;241590;1;0;26404602;12505142;2;0;39.3;18.6;0.0;0.0
FR;2021-06-01;430836;302797;1;0;26835438;12807939;3;0;40.0;19.1;0.0;0.0
FR;2021-06-02;419328;278100;0;0;27254766;13086039;3;0;40.6;19.5;0.0;0.0
FR;2021-06-03;464596;313042;0;0;27719362;13399081;3;0;41.3;20.0;0.0;0.0
FR;2021-06-04;455687;361975;1;0;28175049;13761056;4;0;42.0;20.5;0.0;0.0
FR;2021-06-05;304748;222125;0;0;28479797;13983181;4;0;42.4;20.8;0.0;0.0
FR;2021-06-06;133236;61276;0;0;28613033;14044457;4;0;42.6;20.9;0.0;0.0
FR;2021-06-07;339003;298977;0;0;28952036;14343434;4;0;43.1;21.4;0.0;0.0
FR;2021-06-08;393561;337755;0;0;29345597;14681189;4;0;43.7;21.9;0.0;0.0
FR;2021-06-09;384661;319841;0;0;29730258;15001030;4;0;44.3;22.4;0.0;0.0
FR;2021-06-10;403956;338314;0;0;30134214;15339344;4;0;44.9;22.9;0.0;0.0
FR;2021-06-11;386464;407550;0;0;30520678;15746894;4;0;45.5;23.5;0.0;0.0
FR;2021-06-12;283203;243391;0;0;30803881;15990285;4;0;45.9;23.8;0.0;0.0
FR;2021-06-13;104828;84992;0;0;30908709;16075277;4;0;46.1;24.0;0.0;0.0
FR;2021-06-14;240647;384633;0;0;31149356;16459910;4;0;46.4;24.5;0.0;0.0
FR;2021-06-15;307979;424325;0;0;31457335;16884235;4;0;46.9;25.2;0.0;0.0
FR;2021-06-16;313837;395484;0;0;31771172;17279719;4;0;47.3;25.7;0.0;0.0
FR;2021-06-17;317555;413568;0;0;32088727;17693287;4;0;47.8;26.4;0.0;0.0
FR;2021-06-18;321551;485757;0;0;32410278;18179044;4;0;48.3;27.1;0.0;0.0
FR;2021-06-19;224304;300944;0;0;32634582;18479988;4;0;48.6;27.5;0.0;0.0
FR;2021-06-20;74364;111782;0;0;32708946;18591770;4;0;48.7;27.7;0.0;0.0
FR;2021-06-21;195567;427770;1;0;32904513;19019540;5;0;49.0;28.3;0.0;0.0
FR;2021-06-22;223001;499930;2;0;33127514;19519470;7;0;49.4;29.1;0.0;0.0
FR;2021-06-23;233866;474033;1;0;33361380;19993503;8;0;49.7;29.8;0.0;0.0
FR;2021-06-24;241726;447077;0;0;33603106;20440580;8;0;50.1;30.5;0.0;0.0
FR;2021-06-25;227463;561195;0;0;33830569;21001775;8;0;50.4;31.3;0.0;0.0
FR;2021-06-26;153192;395474;0;0;33983761;21397249;8;0;50.6;31.9;0.0;0.0
FR;2021-06-27;55861;165123;0;0;34039622;21562372;8;0;50.7;32.1;0.0;0.0
FR;2021-06-28;154612;478405;0;0;34194234;22040777;8;0;50.9;32.8;0.0;0.0
FR;2021-06-29;182540;538271;0;0;34376774;22579048;8;0;51.2;33.6;0.0;0.0
FR;2021-06-30;203835;516822;2;0;34580609;23095870;10;0;51.5;34.4;0.0;0.0
FR;2021-07-01;231102;497927;1;0;34811711;23593797;11;0;51.9;35.2;0.0;0.0
FR;2021-07-02;228306;562677;3;0;35040017;24156474;14;0;52.2;36.0;0.0;0.0
FR;2021-07-03;141931;395318;1;0;35181948;24551792;15;0;52.4;36.6;0.0;0.0
FR;2021-07-04;56693;150967;0;0;35238641;24702759;15;0;52.5;36.8;0.0;0.0
FR;2021-07-05;168215;449376;2;0;35406856;25152135;17;0;52.8;37.5;0.0;0.0
FR;2021-07-06;196551;511528;8;0;35603407;25663663;25;0;53.0;38.2;0.0;0.0
FR;2021-07-07;212929;477915;5;0;35816336;26141578;30;0;53.4;39.0;0.0;0.0
FR;2021-07-08;231438;468300;7;0;36047774;26609878;37;0;53.7;39.6;0.0;0.0
FR;2021-07-09;228339;557207;2;0;36276113;27167085;39;0;54.1;40.5;0.0;0.0
FR;2021-07-10;148531;368906;1;0;36424644;27535991;40;0;54.3;41.0;0.0;0.0
FR;2021-07-11;60141;121097;0;0;36484785;27657088;40;0;54.4;41.2;0.0;0.0
FR;2021-07-12;168954;513160;0;0;36653739;28170248;40;0;54.6;42.0;0.0;0.0
FR;2021-07-13;287059;586729;2;0;36940798;28756977;42;0;55.0;42.8;0.0;0.0
FR;2021-07-14;180881;187149;0;0;37121679;28944126;42;0;55.3;43.1;0.0;0.0
FR;2021-07-15;346864;572764;0;0;37468543;29516890;42;0;55.8;44.0;0.0;0.0
FR;2021-07-16;379901;575416;1;0;37848444;30092306;43;0;56.4;44.8;0.0;0.0
FR;2021-07-17;259649;368945;0;0;38108093;30461251;43;0;56.8;45.4;0.0;0.0
FR;2021-07-18;109665;133308;0;0;38217758;30594559;43;0;56.9;45.6;0.0;0.0
FR;2021-07-19;285312;480231;0;0;38503070;31074790;43;0;57.4;46.3;0.0;0.0
FR;2021-07-20;376723;524969;0;0;38879793;31599759;43;0;57.9;47.1;0.0;0.0
FR;2021-07-21;395626;483132;2;0;39275419;32082891;45;0;58.5;47.8;0.0;0.0
FR;2021-07-22;440878;472827;2;0;39716297;32555718;47;0;59.2;48.5;0.0;0.0
FR;2021-07-23;439844;511385;2;0;40156141;33067103;49;0;59.8;49.3;0.0;0.0
FR;2021-07-24;285179;322365;0;0;40441320;33389468;49;0;60.3;49.7;0.0;0.0
FR;2021-07-25;121050;100467;0;0;40562370;33489935;49;0;60.4;49.9;0.0;0.0
FR;2021-07-26;347264;385972;2;0;40909634;33875907;51;0;61.0;50.5;0.0;0.0
FR;2021-07-27;463881;401672;2;0;41373515;34277579;53;0;61.6;51.1;0.0;0.0
FR;2021-07-28;459292;367893;2;0;41832807;34645472;55;0;62.3;51.6;0.0;0.0
FR;2021-07-29;489677;358075;1;0;42322484;35003547;56;0;63.1;52.2;0.0;0.0
FR;2021-07-30;461630;381656;2;0;42784114;35385203;58;0;63.7;52.7;0.0;0.0
FR;2021-07-31;285337;231697;0;0;43069451;35616900;58;0;64.2;53.1;0.0;0.0
FR;2021-08-01;111935;65828;0;0;43181386;35682728;58;0;64.3;53.2;0.0;0.0
FR;2021-08-02;341211;285561;0;0;43522597;35968289;58;0;64.8;53.6;0.0;0.0
FR;2021-08-03;398398;305461;1;0;43920995;36273750;59;0;65.4;54.0;0.0;0.0
FR;2021-08-04;384627;266508;3;0;44305622;36540258;62;0;66.0;54.4;0.0;0.0
FR;2021-08-05;365973;282634;0;0;44671595;36822892;62;0;66.6;54.9;0.0;0.0
FR;2021-08-06;359547;327396;1;0;45031142;37150288;63;0;67.1;55.4;0.0;0.0
FR;2021-08-07;213035;210268;3;0;45244177;37360556;66;0;67.4;55.7;0.0;0.0
FR;2021-08-08;74131;73743;0;0;45318308;37434299;66;0;67.5;55.8;0.0;0.0
FR;2021-08-09;258574;298673;3;0;45576882;37732972;69;0;67.9;56.2;0.0;0.0
FR;2021-08-10;306598;324700;1;0;45883480;38057672;70;0;68.4;56.7;0.0;0.0
FR;2021-08-11;279521;302638;1;0;46163001;38360310;71;0;68.8;57.2;0.0;0.0
FR;2021-08-12;271372;321202;1;0;46434373;38681512;72;0;69.2;57.6;0.0;0.0
FR;2021-08-13;252032;317032;2;0;46686405;38998544;74;0;69.6;58.1;0.0;0.0
FR;2021-08-14;145276;219423;0;0;46831681;39217967;74;0;69.8;58.4;0.0;0.0
FR;2021-08-15;39301;55730;0;0;46870982;39273697;74;0;69.8;58.5;0.0;0.0
FR;2021-08-16;186040;346340;0;0;47057022;39620037;74;0;70.1;59.0;0.0;0.0
FR;2021-08-17;215554;369930;1;0;47272576;39989967;75;0;70.4;59.6;0.0;0.0
FR;2021-08-18;198925;355271;4;0;47471501;40345238;79;0;70.7;60.1;0.0;0.0
FR;2021-08-19;191887;356632;0;0;47663388;40701870;79;0;71.0;60.6;0.0;0.0
FR;2021-08-20;186343;397170;2;0;47849731;41099040;81;0;71.3;61.2;0.0;0.0
FR;2021-08-21;104751;254747;0;0;47954482;41353787;81;0;71.5;61.6;0.0;0.0
FR;2021-08-22;31885;92211;1;0;47986367;41445998;82;0;71.5;61.8;0.0;0.0
FR;2021-08-23;140885;380218;2;0;48127252;41826216;84;0;71.7;62.3;0.0;0.0
FR;2021-08-24;162401;403580;1;0;48289653;42229796;85;0;72.0;62.9;0.0;0.0
FR;2021-08-25;151058;376049;3;0;48440711;42605845;88;0;72.2;63.5;0.0;0.0
FR;2021-08-26;142733;368351;1;0;48583444;42974196;89;0;72.4;64.0;0.0;0.0
FR;2021-08-27;148360;415559;3;0;48731804;43389755;92;0;72.6;64.6;0.0;0.0
FR;2021-08-28;90604;265283;0;0;48822408;43655038;92;0;72.7;65.0;0.0;0.0
FR;2021-08-29;27305;88398;0;0;48849713;43743436;92;0;72.8;65.2;0.0;0.0
FR;2021-08-30;117320;342662;6027;1;48967033;44086098;6119;1;73.0;65.7;0.0;0.0
FR;2021-08-31;128714;354216;11879;2;49095747;44440314;17998;3;73.2;66.2;0.0;0.0
FR;2021-09-01;135742;302701;24310;3;49231489;44743015;42308;6;73.4;66.7;0.1;0.0
FR;2021-09-02;112591;262488;28859;1;49344080;45005503;71167;7;73.5;67.1;0.1;0.0
FR;2021-09-03;118188;309705;32961;6;49462268;45315208;104128;13;73.7;67.5;0.2;0.0
FR;2021-09-04;89796;230677;14071;5;49552064;45545885;118199;18;73.8;67.9;0.2;0.0
FR;2021-09-05;21336;48363;4731;0;49573400;45594248;122930;18;73.9;67.9;0.2;0.0
FR;2021-09-06;75319;191207;34242;2;49648719;45785455;157172;20;74.0;68.2;0.2;0.0
FR;2021-09-07;80074;191504;36094;3;49728793;45976959;193266;23;74.1;68.5;0.3;0.0
FR;2021-09-08;89717;216954;32454;6;49818510;46193913;225720;29;74.2;68.8;0.3;0.0
FR;2021-09-09;76654;174521;36522;16;49895164;46368434;262242;45;74.3;69.1;0.4;0.0
FR;2021-09-10;95590;215253;40518;13;49990754;46583687;302760;58;74.5;69.4;0.5;0.0
FR;2021-09-11;66730;178305;14310;1;50057484;46761992;317070;59;74.6;69.7;0.5;0.0
FR;2021-09-12;12792;34160;3160;2;50070276;46796152;320230;61;74.6;69.7;0.5;0.0
FR;2021-09-13;64366;134679;44042;29;50134642;46930831;364272;90;74.7;69.9;0.5;0.0
FR;2021-09-14;73308;136308;62020;52;50207950;47067139;426292;142;74.8;70.1;0.6;0.0
FR;2021-09-15;76405;174883;54773;99;50284355;47242022;481065;241;74.9;70.4;0.7;0.0
FR;2021-09-16;63755;117981;60014;126;50348110;47360003;541079;367;75.0;70.6;0.8;0.0
FR;2021-09-17;74963;159838;57227;93;50423073;47519841;598306;460;75.1;70.8;0.9;0.0
FR;2021-09-18;48185;144336;17280;24;50471258;47664177;615586;484;75.2;71.0;0.9;0.0
FR;2021-09-19;7866;24928;2621;3;50479124;47689105;618207;487;75.2;71.1;0.9;0.0
FR;2021-09-20;44442;96446;50253;56;50523566;47785551;668460;543;75.3;71.2;1.0;0.0
FR;2021-09-21;45806;98509;63365;128;50569372;47884060;731825;671;75.3;71.3;1.1;0.0
FR;2021-09-22;48585;144835;55346;67;50617957;48028895;787171;738;75.4;71.6;1.2;0.0
FR;2021-09-23;43162;91255;63469;123;50661119;48120150;850640;861;75.5;71.7;1.3;0.0
FR;2021-09-24;52204;132454;59088;104;50713323;48252604;909728;965;75.6;71.9;1.4;0.0
FR;2021-09-25;35191;118558;18253;27;50748514;48371162;927981;992;75.6;72.1;1.4;0.0
FR;2021-09-26;5524;18691;2329;5;50754038;48389853;930310;997;75.6;72.1;1.4;0.0
FR;2021-09-27;33920;78889;48125;113;50787958;48468742;978435;1110;75.7;72.2;1.5;0.0
FR;2021-09-28;36444;74410;56459;82;50824402;48543152;1034894;1192;75.7;72.3;1.5;0.0
FR;2021-09-29;44311;103040;54805;77;50868713;48646192;1089699;1269;75.8;72.5;1.6;0.0
FR;2021-09-30;36268;71387;59473;85;50904981;48717579;1149172;1354;75.8;72.6;1.7;0.0
FR;2021-10-01;61515;99695;63679;54;50966496;48817274;1212851;1408;75.9;72.7;1.8;0.0
FR;2021-10-02;39413;81687;23316;18;51005909;48898961;1236167;1426;76.0;72.9;1.8;0.0
FR;2021-10-03;5261;11290;2539;4;51011170;48910251;1238706;1430;76.0;72.9;1.8;0.0
FR;2021-10-04;34953;59564;54775;82;51046123;48969815;1293481;1512;76.1;73.0;1.9;0.0
FR;2021-10-05;33555;62208;64914;73;51079678;49032023;1358395;1585;76.1;73.1;2.0;0.0
FR;2021-10-06;42416;80220;68213;42;51122094;49112243;1426608;1627;76.2;73.2;2.1;0.0
FR;2021-10-07;30391;59467;68659;87;51152485;49171710;1495267;1714;76.2;73.3;2.2;0.0
FR;2021-10-08;48741;89886;84609;71;51201226;49261596;1579876;1785;76.3;73.4;2.4;0.0
FR;2021-10-09;33621;64135;33853;20;51234847;49325731;1613729;1805;76.3;73.5;2.4;0.0
FR;2021-10-10;4586;7929;3483;2;51239433;49333660;1617212;1807;76.3;73.5;2.4;0.0
FR;2021-10-11;30558;50660;64020;94;51269991;49384320;1681232;1901;76.4;73.6;2.5;0.0
FR;2021-10-12;31340;51437;75827;59;51301331;49435757;1757059;1960;76.4;73.7;2.6;0.0
FR;2021-10-13;39979;62839;79248;51;51341310;49498596;1836307;2011;76.5;73.8;2.7;0.0
FR;2021-10-14;30223;49748;73752;49;51371533;49548344;1910059;2060;76.5;73.8;2.8;0.0
FR;2021-10-15;44734;70459;102886;60;51416267;49618803;2012945;2120;76.6;73.9;3.0;0.0
FR;2021-10-16;31269;46726;39608;24;51447536;49665529;2052553;2144;76.7;74.0;3.1;0.0
FR;2021-10-17;3827;5695;3692;3;51451363;49671224;2056245;2147;76.7;74.0;3.1;0.0
FR;2021-10-18;28287;42674;71332;36;51479650;49713898;2127577;2183;76.7;74.1;3.2;0.0
FR;2021-10-19;27049;42175;81600;71;51506699;49756073;2209177;2254;76.7;74.1;3.3;0.0
FR;2021-10-20;35202;51886;101456;93;51541901;49807959;2310633;2347;76.8;74.2;3.4;0.0
FR;2021-10-21;25929;42012;89100;45;51567830;49849971;2399733;2392;76.8;74.3;3.6;0.0
FR;2021-10-22;38199;59329;112476;91;51606029;49909300;2512209;2483;76.9;74.4;3.7;0.0
FR;2021-10-23;26968;42455;48594;24;51632997;49951755;2560803;2507;76.9;74.4;3.8;0.0
FR;2021-10-24;2912;5021;3936;3;51635909;49956776;2564739;2510;76.9;74.4;3.8;0.0
FR;2021-10-25;25973;35640;86594;67;51661882;49992416;2651333;2577;77.0;74.5;4.0;0.0
FR;2021-10-26;23681;32301;92311;48;51685563;50024717;2743644;2625;77.0;74.5;4.1;0.0
FR;2021-10-27;30005;44205;114607;73;51715568;50068922;2858251;2698;77.1;74.6;4.3;0.0
FR;2021-10-28;23380;31210;94362;62;51738948;50100132;2952613;2760;77.1;74.6;4.4;0.0
FR;2021-10-29;31503;46519;125240;80;51770451;50146651;3077853;2840;77.1;74.7;4.6;0.0
FR;2021-10-30;20523;32843;53354;27;51790974;50179494;3131207;2867;77.2;74.8;4.7;0.0
FR;2021-10-31;2477;3874;3867;3;51793451;50183368;3135074;2870;77.2;74.8;4.7;0.0
FR;2021-11-01;8195;4961;3555;10;51801646;50188329;3138629;2880;77.2;74.8;4.7;0.0
FR;2021-11-02;25277;36346;99463;64;51826923;50224675;3238092;2944;77.2;74.8;4.8;0.0
FR;2021-11-03;29757;43602;125774;97;51856680;50268277;3363866;3041;77.3;74.9;5.0;0.0
FR;2021-11-04;23661;31635;114317;68;51880341;50299912;3478183;3109;77.3;74.9;5.2;0.0
FR;2021-11-05;32266;44711;151250;84;51912607;50344623;3629433;3193;77.3;75.0;5.4;0.0
FR;2021-11-06;21478;32459;68224;40;51934085;50377082;3697657;3233;77.4;75.1;5.5;0.0
FR;2021-11-07;2377;4058;5582;8;51936462;50381140;3703239;3241;77.4;75.1;5.5;0.0
FR;2021-11-08;20395;31076;134152;73;51956857;50412216;3837391;3314;77.4;75.1;5.7;0.0
FR;2021-11-09;22126;33107;172104;107;51978983;50445323;4009495;3421;77.4;75.2;6.0;0.0
FR;2021-11-10;31364;44237;198666;128;52010347;50489560;4208161;3549;77.5;75.2;6.3;0.0
FR;2021-11-11;4304;5856;13922;20;52014651;50495416;4222083;3569;77.5;75.2;6.3;0.0
FR;2021-11-12;28987;41886;197252;127;52043638;50537302;4419335;3696;77.5;75.3;6.6;0.0
FR;2021-11-13;20293;28357;86290;60;52063931;50565659;4505625;3756;77.6;75.3;6.7;0.0
FR;2021-11-14;2331;3404;7878;10;52066262;50569063;4513503;3766;77.6;75.3;6.7;0.0
FR;2021-11-15;20300;28075;171441;102;52086562;50597138;4684944;3868;77.6;75.4;7.0;0.0
FR;2021-11-16;23341;28005;214865;152;52109903;50625143;4899809;4020;77.6;75.4;7.3;0.0
FR;2021-11-17;30349;36724;212788;132;52140252;50661867;5112597;4152;77.7;75.5;7.6;0.0
FR;2021-11-18;23344;28817;205393;123;52163596;50690684;5317990;4275;77.7;75.5;7.9;0.0
FR;2021-11-19;33554;40094;262060;186;52197150;50730778;5580050;4461;77.8;75.6;8.3;0.0
FR;2021-11-20;25319;29401;109660;63;52222469;50760179;5689710;4524;77.8;75.6;8.5;0.0
FR;2021-11-21;2623;3483;10643;17;52225092;50763662;5700353;4541;77.8;75.6;8.5;0.0
FR;2021-11-22;22740;19166;194742;85;52247832;50782828;5895095;4626;77.8;75.7;8.8;0.0
FR;2021-11-23;25563;24460;247721;82;52273395;50807288;6142816;4708;77.9;75.7;9.2;0.0
FR;2021-11-24;31761;34776;243115;80;52305156;50842064;6385931;4788;77.9;75.8;9.5;0.0
FR;2021-11-25;25383;25194;277569;111;52330539;50867258;6663500;4899;78.0;75.8;9.9;0.0
FR;2021-11-26;33202;37584;414499;160;52363741;50904842;7077999;5059;78.0;75.8;10.5;0.0
FR;2021-11-27;23298;28646;236556;148;52387039;50933488;7314555;5207;78.1;75.9;10.9;0.0
FR;2021-11-28;3479;4128;63328;41;52390518;50937616;7377883;5248;78.1;75.9;11.0;0.0
FR;2021-11-29;19384;23458;371538;175;52409902;50961074;7749421;5423;78.1;75.9;11.5;0.0
FR;2021-11-30;24725;27260;500632;280;52434627;50988334;8250053;5703;78.1;76.0;12.3;0.0
FR;2021-12-01;26850;31868;511173;300;52461477;51020202;8761226;6003;78.2;76.0;13.1;0.0
FR;2021-12-02;21974;21381;574687;302;52483451;51041583;9335913;6305;78.2;76.1;13.9;0.0
FR;2021-12-03;25474;34147;650965;325;52508925;51075730;9986878;6630;78.2;76.1;14.9;0.0
FR;2021-12-04;18287;25916;369683;216;52527212;51101646;10356561;6846;78.3;76.1;15.4;0.0
FR;2021-12-05;4142;4963;107051;94;52531354;51106609;10463612;6940;78.3;76.1;15.6;0.0
FR;2021-12-06;22762;25748;539818;383;52554116;51132357;11003430;7323;78.3;76.2;16.4;0.0
FR;2021-12-07;23309;29174;706137;407;52577425;51161531;11709567;7730;78.3;76.2;17.4;0.0
FR;2021-12-08;25333;35436;647320;436;52602758;51196967;12356887;8166;78.4;76.3;18.4;0.0
FR;2021-12-09;23991;29488;726168;454;52626749;51226455;13083055;8620;78.4;76.3;19.5;0.0
FR;2021-12-10;27675;38320;805969;461;52654424;51264775;13889024;9081;78.5;76.4;20.7;0.0
FR;2021-12-11;20222;29945;480322;353;52674646;51294720;14369346;9434;78.5;76.4;21.4;0.0
FR;2021-12-12;5624;6465;159227;107;52680270;51301185;14528573;9541;78.5;76.4;21.6;0.0
FR;2021-12-13;21061;30178;649185;393;52701331;51331363;15177758;9934;78.5;76.5;22.6;0.0
FR;2021-12-14;27574;35841;847351;681;52728905;51367204;16025109;10615;78.6;76.5;23.9;0.0
FR;2021-12-15;28201;39922;768910;490;52757106;51407126;16794019;11105;78.6;76.6;25.0;0.0
FR;2021-12-16;27933;35610;844260;504;52785039;51442736;17638279;11609;78.6;76.6;26.3;0.0
FR;2021-12-17;31544;43772;891982;592;52816583;51486508;18530261;12201;78.7;76.7;27.6;0.0
FR;2021-12-18;24912;30239;522144;365;52841495;51516747;19052405;12566;78.7;76.8;28.4;0.0
FR;2021-12-19;8741;7969;191143;140;52850236;51524716;19243548;12706;78.7;76.8;28.7;0.0
FR;2021-12-20;31585;34243;658594;488;52881821;51558959;19902142;13194;78.8;76.8;29.7;0.0
FR;2021-12-21;39213;39249;759460;578;52921034;51598208;20661602;13772;78.9;76.9;30.8;0.0
FR;2021-12-22;39458;37475;642028;702;52960492;51635683;21303630;14474;78.9;76.9;31.7;0.0
FR;2021-12-23;33742;30386;494321;592;52994234;51666069;21797951;15066;79.0;77.0;32.5;0.0
FR;2021-12-24;10664;11608;126632;240;53004898;51677677;21924583;15306;79.0;77.0;32.7;0.0
FR;2021-12-25;767;1937;9026;72;53005665;51679614;21933609;15378;79.0;77.0;32.7;0.0
FR;2021-12-26;4696;4764;60131;169;53010361;51684378;21993740;15547;79.0;77.0;32.8;0.0
FR;2021-12-27;30372;33160;509084;673;53040733;51717538;22502824;16220;79.0;77.1;33.5;0.0
FR;2021-12-28;38307;35305;632152;1556;53079040;51752843;23134976;17776;79.1;77.1;34.5;0.0
FR;2021-12-29;39842;33277;560914;1752;53118882;51786120;23695890;19528;79.1;77.2;35.3;0.0
FR;2021-12-30;35886;29444;471094;1881;53154768;51815564;24166984;21409;79.2;77.2;36.0;0.0
FR;2021-12-31;12034;11339;131619;755;53166802;51826903;24298603;22164;79.2;77.2;36.2;0.0
FR;2022-01-01;1324;1764;9928;100;53168126;51828667;24308531;22264;79.2;77.2;36.2;0.0
FR;2022-01-02;6075;5083;66929;408;53174201;51833750;24375460;22672;79.2;77.2;36.3;0.0
FR;2022-01-03;32626;36587;551477;2642;53206827;51870337;24926937;25314;79.3;77.3;37.1;0.0
FR;2022-01-04;40885;40502;714205;3839;53247712;51910839;25641142;29153;79.3;77.3;38.2;0.0
FR;2022-01-05;60313;43391;634056;3436;53308025;51954230;26275198;32589;79.4;77.4;39.1;0.0
FR;2022-01-06;43926;40055;711315;4563;53351951;51994285;26986513;37152;79.5;77.5;40.2;0.1
FR;2022-01-07;50547;46580;790322;5004;53402498;52040865;27776835;42156;79.6;77.5;41.4;0.1
FR;2022-01-08;44951;35010;472843;2443;53447449;52075875;28249678;44599;79.6;77.6;42.1;0.1
FR;2022-01-09;15596;11489;145698;830;53463045;52087364;28395376;45429;79.7;77.6;42.3;0.1
FR;2022-01-10;35012;38467;522172;3719;53498057;52125831;28917548;49148;79.7;77.7;43.1;0.1
FR;2022-01-11;41643;42030;608385;5215;53539700;52167861;29525933;54363;79.8;77.7;44.0;0.1
FR;2022-01-12;60148;49207;504227;4492;53599848;52217068;30030160;58855;79.9;77.8;44.7;0.1
FR;2022-01-13;37903;40289;540936;5461;53637751;52257357;30571096;64316;79.9;77.9;45.6;0.1
FR;2022-01-14;42384;43346;628953;6459;53680135;52300703;31200049;70775;80.0;77.9;46.5;0.1
FR;2022-01-15;39305;31274;377538;3293;53719440;52331977;31577587;74068;80.0;78.0;47.0;0.1
FR;2022-01-16;11381;9012;99442;760;53730821;52340989;31677029;74828;80.1;78.0;47.2;0.1
FR;2022-01-17;24600;28024;354131;3961;53755421;52369013;32031160;78789;80.1;78.0;47.7;0.1
FR;2022-01-18;28102;31751;397500;5774;53783523;52400764;32428660;84563;80.1;78.1;48.3;0.1
FR;2022-01-19;43042;40267;311043;4385;53826565;52441031;32739703;88948;80.2;78.1;48.8;0.1
FR;2022-01-20;23407;29321;328417;5627;53849972;52470352;33068120;94575;80.2;78.2;49.3;0.1
FR;2022-01-21;27988;32965;401119;6583;53877960;52503317;33469239;101158;80.3;78.2;49.9;0.2
FR;2022-01-22;27607;27166;241743;2842;53905567;52530483;33710982;104000;80.3;78.3;50.2;0.2
FR;2022-01-23;6701;7515;55181;589;53912268;52537998;33766163;104589;80.3;78.3;50.3;0.2
FR;2022-01-24;16194;25051;239311;4095;53928462;52563049;34005474;108684;80.4;78.3;50.7;0.2
FR;2022-01-25;18902;28570;267029;6066;53947364;52591619;34272503;114750;80.4;78.4;51.1;0.2
FR;2022-01-26;28107;41033;229339;4474;53975471;52632652;34501842;119224;80.4;78.4;51.4;0.2
FR;2022-01-27;16273;25696;225809;5692;53991744;52658348;34727651;124916;80.4;78.5;51.7;0.2
FR;2022-01-28;21497;41818;321451;7410;54013241;52700166;35049102;132326;80.5;78.5;52.2;0.2
FR;2022-01-29;18401;32672;204571;3249;54031642;52732838;35253673;135575;80.5;78.6;52.5;0.2
FR;2022-01-30;4466;9154;45090;639;54036108;52741992;35298763;136214;80.5;78.6;52.6;0.2
FR;2022-01-31;11220;25956;164779;4243;54047328;52767948;35463542;140457;80.5;78.6;52.8;0.2
FR;2022-02-01;12806;27097;191359;7099;54060134;52795045;35654901;147556;80.5;78.7;53.1;0.2
FR;2022-02-02;20004;45652;190119;5992;54080138;52840697;35845020;153548;80.6;78.7;53.4;0.2
FR;2022-02-03;10957;24616;173293;6968;54091095;52865313;36018313;160516;80.6;78.8;53.7;0.2
FR;2022-02-04;14485;35931;264165;9206;54105580;52901244;36282478;169722;80.6;78.8;54.1;0.3
FR;2022-02-05;12782;31921;172333;3816;54118362;52933165;36454811;173538;80.6;78.9;54.3;0.3
FR;2022-02-06;2705;7328;33825;663;54121067;52940493;36488636;174201;80.6;78.9;54.4;0.3
FR;2022-02-07;9316;24426;176311;5290;54130383;52964919;36664947;179491;80.7;78.9;54.6;0.3
FR;2022-02-08;9591;20521;184321;7049;54139974;52985440;36849268;186540;80.7;78.9;54.9;0.3
FR;2022-02-09;14156;34956;192954;5778;54154130;53020396;37042222;192318;80.7;79.0;55.2;0.3
FR;2022-02-10;8263;17859;166571;6496;54162393;53038255;37208793;198814;80.7;79.0;55.4;0.3
FR;2022-02-11;10743;25598;243000;8324;54173136;53063853;37451793;207138;80.7;79.1;55.8;0.3
FR;2022-02-12;8344;22551;151703;3502;54181480;53086404;37603496;210640;80.7;79.1;56.0;0.3
FR;2022-02-13;1894;4391;30903;540;54183374;53090795;37634399;211180;80.7;79.1;56.1;0.3
FR;2022-02-14;6903;14505;166303;4774;54190277;53105300;37800702;215954;80.7;79.1;56.3;0.3
FR;2022-02-15;6850;15240;162436;6846;54197127;53120540;37963138;222800;80.8;79.1;56.6;0.3
FR;2022-02-16;9286;25600;146644;5720;54206413;53146140;38109782;228520;80.8;79.2;56.8;0.3
FR;2022-02-17;5367;12553;94757;5403;54211780;53158693;38204539;233923;80.8;79.2;56.9;0.3
FR;2022-02-18;6875;18414;129240;7399;54218655;53177107;38333779;241322;80.8;79.2;57.1;0.4
FR;2022-02-19;5341;15802;77300;3016;54223996;53192909;38411079;244338;80.8;79.3;57.2;0.4
FR;2022-02-20;1135;2882;13924;459;54225131;53195791;38425003;244797;80.8;79.3;57.3;0.4
FR;2022-02-21;4020;10036;67134;4058;54229151;53205827;38492137;248855;80.8;79.3;57.4;0.4
FR;2022-02-22;4368;11095;64406;5249;54233519;53216922;38556543;254104;80.8;79.3;57.4;0.4
FR;2022-02-23;6509;19383;71856;4590;54240028;53236305;38628399;258694;80.8;79.3;57.6;0.4
FR;2022-02-24;3744;9124;53179;4530;54243772;53245429;38681578;263224;80.8;79.3;57.6;0.4
FR;2022-02-25;5196;14522;79994;7327;54248968;53259951;38761572;270551;80.8;79.4;57.8;0.4
FR;2022-02-26;3970;12036;51453;3083;54252938;53271987;38813025;273634;80.8;79.4;57.8;0.4
FR;2022-02-27;870;1955;8932;529;54253808;53273942;38821957;274163;80.8;79.4;57.8;0.4
FR;2022-02-28;3067;7208;42874;3850;54256875;53281150;38864831;278013;80.8;79.4;57.9;0.4
FR;2022-03-01;3121;7276;44762;5509;54259996;53288426;38909593;283522;80.8;79.4;58.0;0.4
FR;2022-03-02;5075;12508;48985;4921;54265071;53300934;38958578;288443;80.9;79.4;58.0;0.4
FR;2022-03-03;2647;5790;29918;4043;54267718;53306724;38988496;292486;80.9;79.4;58.1;0.4
FR;2022-03-04;3175;8177;39384;6208;54270893;53314901;39027880;298694;80.9;79.4;58.2;0.4
FR;2022-03-05;2918;7058;25073;3130;54273811;53321959;39052953;301824;80.9;79.4;58.2;0.4
FR;2022-03-06;509;1009;3429;378;54274320;53322968;39056382;302202;80.9;79.5;58.2;0.5
FR;2022-03-07;1936;3695;17651;3298;54276256;53326663;39074033;305500;80.9;79.5;58.2;0.5
FR;2022-03-08;1966;4145;17858;4089;54278222;53330808;39091891;309589;80.9;79.5;58.2;0.5
FR;2022-03-09;3446;8507;21222;4029;54281668;53339315;39113113;313618;80.9;79.5;58.3;0.5
FR;2022-03-10;1709;3769;15676;3394;54283377;53343084;39128789;317012;80.9;79.5;58.3;0.5
FR;2022-03-11;2342;5171;22222;5468;54285719;53348255;39151011;322480;80.9;79.5;58.3;0.5
FR;2022-03-12;2656;5426;16498;3132;54288375;53353681;39167509;325612;80.9;79.5;58.4;0.5
FR;2022-03-13;385;588;2253;529;54288760;53354269;39169762;326141;80.9;79.5;58.4;0.5
FR;2022-03-14;1458;2673;13784;7280;54290218;53356942;39183546;333421;80.9;79.5;58.4;0.5
FR;2022-03-15;1593;2998;14330;11012;54291811;53359940;39197876;344433;80.9;79.5;58.4;0.5
FR;2022-03-16;2941;5842;18014;16285;54294752;53365782;39215890;360718;80.9;79.5;58.4;0.5
FR;2022-03-17;1369;2501;11930;13293;54296121;53368283;39227820;374011;80.9;79.5;58.4;0.6
FR;2022-03-18;2197;3845;18019;22011;54298318;53372128;39245839;396022;80.9;79.5;58.5;0.6
FR;2022-03-19;2274;3995;12398;11402;54300592;53376123;39258237;407424;80.9;79.5;58.5;0.6
FR;2022-03-20;292;501;1915;1332;54300884;53376624;39260152;408756;80.9;79.5;58.5;0.6
FR;2022-03-21;1341;2057;11908;16898;54302225;53378681;39272060;425654;80.9;79.5;58.5;0.6
FR;2022-03-22;1460;2417;12508;22811;54303685;53381098;39284568;448465;80.9;79.5;58.5;0.7
FR;2022-03-23;2632;5001;17142;25241;54306317;53386099;39301710;473706;80.9;79.5;58.6;0.7
FR;2022-03-24;1354;2010;10612;19350;54307671;53388109;39312322;493056;80.9;79.5;58.6;0.7
FR;2022-03-25;2045;3327;16814;30772;54309716;53391436;39329136;523828;80.9;79.6;58.6;0.8
FR;2022-03-26;2215;3692;11496;14377;54311931;53395128;39340632;538205;80.9;79.6;58.6;0.8
FR;2022-03-27;353;500;1908;1730;54312284;53395628;39342540;539935;80.9;79.6;58.6;0.8
FR;2022-03-28;1409;1952;10541;19024;54313693;53397580;39353081;558959;80.9;79.6;58.6;0.8
FR;2022-03-29;1419;2022;12003;29231;54315112;53399602;39365084;588190;80.9;79.6;58.7;0.9
FR;2022-03-30;2807;4545;14991;29250;54317919;53404147;39380075;617440;80.9;79.6;58.7;0.9
FR;2022-03-31;1589;2114;12184;26473;54319508;53406261;39392259;643913;80.9;79.6;58.7;1.0
FR;2022-04-01;2077;2646;18589;33405;54321585;53408907;39410848;677318;80.9;79.6;58.7;1.0
FR;2022-04-02;1490;1967;8683;11266;54323075;53410874;39419531;688584;80.9;79.6;58.7;1.0
FR;2022-04-03;272;338;1570;1378;54323347;53411212;39421101;689962;80.9;79.6;58.7;1.0
FR;2022-04-04;1317;1555;11340;20520;54324664;53412767;39432441;710482;80.9;79.6;58.8;1.1
FR;2022-04-05;1577;1787;13070;35585;54326241;53414554;39445511;746067;80.9;79.6;58.8;1.1
FR;2022-04-06;2026;2677;12644;27773;54328267;53417231;39458155;773840;80.9;79.6;58.8;1.2
FR;2022-04-07;1419;1687;12773;34937;54329686;53418918;39470928;808777;81.0;79.6;58.8;1.2
FR;2022-04-08;2009;2393;17719;45994;54331695;53421311;39488647;854771;81.0;79.6;58.8;1.3
FR;2022-04-09;1341;1869;8834;14769;54333036;53423180;39497481;869540;81.0;79.6;58.9;1.3
FR;2022-04-10;271;363;1971;2254;54333307;53423543;39499452;871794;81.0;79.6;58.9;1.3
FR;2022-04-11;1172;1467;11401;24898;54334479;53425010;39510853;896692;81.0;79.6;58.9;1.3
FR;2022-04-12;1559;1650;13244;41407;54336038;53426660;39524097;938099;81.0;79.6;58.9;1.4
FR;2022-04-13;1835;2400;12873;33695;54337873;53429060;39536970;971794;81.0;79.6;58.9;1.4
FR;2022-04-14;1429;1584;12843;36541;54339302;53430644;39549813;1008335;81.0;79.6;58.9;1.5
FR;2022-04-15;1766;2049;14713;36855;54341068;53432693;39564526;1045190;81.0;79.6;59.0;1.6
FR;2022-04-16;1025;1231;6209;9404;54342093;53433924;39570735;1054594;81.0;79.6;59.0;1.6
FR;2022-04-17;183;198;1027;1223;54342276;53434122;39571762;1055817;81.0;79.6;59.0;1.6
FR;2022-04-18;142;230;2741;1247;54342418;53434352;39574503;1057064;81.0;79.6;59.0;1.6
FR;2022-04-19;1458;1739;12324;30405;54343876;53436091;39586827;1087469;81.0;79.6;59.0;1.6
FR;2022-04-20;1885;2414;12790;29687;54345761;53438505;39599617;1117156;81.0;79.6;59.0;1.7
FR;2022-04-21;1465;1680;12409;35286;54347226;53440185;39612026;1152442;81.0;79.6;59.0;1.7
FR;2022-04-22;1810;2210;15728;38869;54349036;53442395;39627754;1191311;81.0;79.6;59.0;1.8
FR;2022-04-23;1110;1439;7195;11413;54350146;53443834;39634949;1202724;81.0;79.6;59.1;1.8
FR;2022-04-24;232;301;1397;1828;54350378;53444135;39636346;1204552;81.0;79.6;59.1;1.8
FR;2022-04-25;1238;1496;10391;21829;54351616;53445631;39646737;1226381;81.0;79.6;59.1;1.8
FR;2022-04-26;1544;1864;12983;38908;54353160;53447495;39659720;1265289;81.0;79.6;59.1;1.9
FR;2022-04-27;1884;2183;11441;30919;54355044;53449678;39671161;1296208;81.0;79.6;59.1;1.9
FR;2022-04-28;1514;1695;12086;35956;54356558;53451373;39683247;1332164;81.0;79.6;59.1;2.0
FR;2022-04-29;1935;2209;14684;38247;54358493;53453582;39697931;1370411;81.0;79.6;59.1;2.0
FR;2022-04-30;1173;1257;6566;10524;54359666;53454839;39704497;1380935;81.0;79.6;59.2;2.1
FR;2022-05-01;169;199;872;1083;54359835;53455038;39705369;1382018;81.0;79.6;59.2;2.1
FR;2022-05-02;1123;1240;10357;18582;54360958;53456278;39715726;1400600;81.0;79.6;59.2;2.1
FR;2022-05-03;1699;1704;13045;34900;54362657;53457982;39728771;1435500;81.0;79.7;59.2;2.1
FR;2022-05-04;1777;1888;11446;25584;54364434;53459870;39740217;1461084;81.0;79.7;59.2;2.2
FR;2022-05-05;1577;1616;11709;33481;54366011;53461486;39751926;1494565;81.0;79.7;59.2;2.2
FR;2022-05-06;2014;2129;14366;37808;54368025;53463615;39766292;1532373;81.0;79.7;59.3;2.3
FR;2022-05-07;1155;1205;6174;10248;54369180;53464820;39772466;1542621;81.0;79.7;59.3;2.3
FR;2022-05-08;250;261;1144;1609;54369430;53465081;39773610;1544230;81.0;79.7;59.3;2.3
FR;2022-05-09;1209;1176;8918;20658;54370639;53466257;39782528;1564888;81.0;79.7;59.3;2.3
FR;2022-05-10;1596;1657;11868;39016;54372235;53467914;39794396;1603904;81.0;79.7;59.3;2.4
FR;2022-05-11;1889;1944;9815;27815;54374124;53469858;39804211;1631719;81.0;79.7;59.3;2.4
FR;2022-05-12;1485;1517;10382;35675;54375609;53471375;39814593;1667394;81.0;79.7;59.3;2.5
FR;2022-05-13;1885;1869;12717;38262;54377494;53473244;39827310;1705656;81.0;79.7;59.3;2.5
FR;2022-05-14;1108;1094;5330;11202;54378602;53474338;39832640;1716858;81.0;79.7;59.3;2.6
FR;2022-05-15;258;214;1199;1538;54378860;53474552;39833839;1718396;81.0;79.7;59.4;2.6
FR;2022-05-16;1104;1036;7348;20724;54379964;53475588;39841187;1739120;81.0;79.7;59.4;2.6
FR;2022-05-17;1494;1454;9972;37430;54381458;53477042;39851159;1776550;81.0;79.7;59.4;2.6
FR;2022-05-18;1699;1721;8332;26715;54383157;53478763;39859491;1803265;81.0;79.7;59.4;2.7
FR;2022-05-19;1341;1394;9266;34297;54384498;53480157;39868757;1837562;81.0;79.7;59.4;2.7
FR;2022-05-20;1768;1798;11254;38846;54386266;53481955;39880011;1876408;81.0;79.7;59.4;2.8
FR;2022-05-21;1118;1183;4860;10134;54387384;53483138;39884871;1886542;81.0;79.7;59.4;2.8
FR;2022-05-22;213;225;926;1393;54387597;53483363;39885797;1887935;81.0;79.7;59.4;2.8
FR;2022-05-23;1005;1085;6525;19076;54388602;53484448;39892322;1907011;81.0;79.7;59.4;2.8
