fra;jour;n_dose1;n_complet;n_rappel;n_2_rappel;n_cum_dose1;n_cum_complet;n_cum_rappel;n_cum_2_rappel;couv_dose1;couv_complet;couv_rappel;couv_2_rappel
FR;2020-12-27;602;55;0;0;602;55;0;0;0.0;0.0;0.0;0.0
FR;2020-12-28;666;42;0;0;1268;97;0;0;0.0;0.0;0.0;0.0
FR;2020-12-29;373;19;0;0;1641;116;0;0;0.0;0.0;0.0;0.0
FR;2020-12-30;439;18;0;0;2080;134;0;0;0.0;0.0;0.0;0.0
FR;2020-12-31;416;22;0;0;2496;156;0;0;0.0;0.0;0.0;0.0
FR;2021-01-01;1135;64;0;0;3631;220;0;0;0.0;0.0;0.0;0.0
FR;2021-01-02;356;30;0;0;3987;250;0;0;0.0;0.0;0.0;0.0
FR;2021-01-03;400;27;0;0;4387;277;0;0;0.0;0.0;0.0;0.0
FR;2021-01-04;2087;48;0;0;6474;325;0;0;0.0;0.0;0.0;0.0
FR;2021-01-05;7574;123;0;0;14048;448;0;0;0.0;0.0;0.0;0.0
FR;2021-01-06;12414;120;0;0;26462;568;0;0;0.0;0.0;0.0;0.0
FR;2021-01-07;29446;157;0;0;55908;725;0;0;0.1;0.0;0.0;0.0
FR;2021-01-08;37120;195;0;0;93028;920;0;0;0.1;0.0;0.0;0.0
FR;2021-01-09;11209;75;0;0;104237;995;0;0;0.2;0.0;0.0;0.0
FR;2021-01-10;5996;24;0;0;110233;1019;0;0;0.2;0.0;0.0;0.0
FR;2021-01-11;39923;225;0;0;150156;1244;0;0;0.2;0.0;0.0;0.0
FR;2021-01-12;62121;310;0;0;212277;1554;0;0;0.3;0.0;0.0;0.0
FR;2021-01-13;65096;429;0;0;277373;1983;0;0;0.4;0.0;0.0;0.0
FR;2021-01-14;83123;1189;0;0;360496;3172;0;0;0.5;0.0;0.0;0.0
FR;2021-01-15;68988;561;0;0;429484;3733;0;0;0.6;0.0;0.0;0.0
FR;2021-01-16;20208;187;0;0;449692;3920;0;0;0.7;0.0;0.0;0.0
FR;2021-01-17;10976;131;0;0;460668;4051;0;0;0.7;0.0;0.0;0.0
FR;2021-01-18;85880;612;0;0;546548;4663;0;0;0.8;0.0;0.0;0.0
FR;2021-01-19;130572;864;0;0;677120;5527;0;0;1.0;0.0;0.0;0.0
FR;2021-01-20;137525;852;0;0;814645;6379;0;0;1.2;0.0;0.0;0.0
FR;2021-01-21;158372;969;0;0;973017;7348;0;0;1.4;0.0;0.0;0.0
FR;2021-01-22;121038;833;0;0;1094055;8181;0;0;1.6;0.0;0.0;0.0
FR;2021-01-23;38464;203;0;0;1132519;8384;0;0;1.7;0.0;0.0;0.0
FR;2021-01-24;9740;134;0;0;1142259;8518;0;0;1.7;0.0;0.0;0.0
FR;2021-01-25;78221;1630;0;0;1220480;10148;0;0;1.8;0.0;0.0;0.0
FR;2021-01-26;100360;3762;0;0;1320840;13910;0;0;2.0;0.0;0.0;0.0
FR;2021-01-27;107223;6647;0;0;1428063;20557;0;0;2.1;0.0;0.0;0.0
FR;2021-01-28;124324;15796;0;0;1552387;36353;0;0;2.3;0.1;0.0;0.0
FR;2021-01-29;92170;18275;0;0;1644557;54628;0;0;2.5;0.1;0.0;0.0
FR;2021-01-30;29111;4375;0;0;1673668;59003;0;0;2.5;0.1;0.0;0.0
FR;2021-01-31;5225;1770;0;0;1678893;60773;0;0;2.5;0.1;0.0;0.0
FR;2021-02-01;53103;21748;0;0;1731996;82521;0;0;2.6;0.1;0.0;0.0
FR;2021-02-02;72275;36124;0;0;1804271;118645;0;0;2.7;0.2;0.0;0.0
FR;2021-02-03;72287;38422;0;0;1876558;157067;0;0;2.8;0.2;0.0;0.0
FR;2021-02-04;82049;52029;0;0;1958607;209096;0;0;2.9;0.3;0.0;0.0
FR;2021-02-05;68215;46486;0;0;2026822;255582;0;0;3.0;0.4;0.0;0.0
FR;2021-02-06;23109;10966;0;0;2049931;266548;0;0;3.1;0.4;0.0;0.0
FR;2021-02-07;5182;5373;0;0;2055113;271921;0;0;3.1;0.4;0.0;0.0
FR;2021-02-08;46815;47263;0;0;2101928;319184;0;0;3.1;0.5;0.0;0.0
FR;2021-02-09;65990;75359;0;0;2167918;394543;0;0;3.2;0.6;0.0;0.0
FR;2021-02-10;70985;80435;0;0;2238903;474978;0;0;3.3;0.7;0.0;0.0
FR;2021-02-11;87237;102827;0;0;2326140;577805;0;0;3.5;0.9;0.0;0.0
FR;2021-02-12;79288;76502;0;0;2405428;654307;0;0;3.6;1.0;0.0;0.0
FR;2021-02-13;22351;19782;0;0;2427779;674089;0;0;3.6;1.0;0.0;0.0
FR;2021-02-14;5071;7299;0;0;2432850;681388;0;0;3.6;1.0;0.0;0.0
FR;2021-02-15;38068;77391;0;0;2470918;758779;0;0;3.7;1.1;0.0;0.0
FR;2021-02-16;50363;101683;0;0;2521281;860462;0;0;3.8;1.3;0.0;0.0
FR;2021-02-17;50499;105785;0;0;2571780;966247;0;0;3.8;1.4;0.0;0.0
FR;2021-02-18;69756;122183;0;0;2641536;1088430;0;0;3.9;1.6;0.0;0.0
FR;2021-02-19;65048;92696;0;0;2706584;1181126;0;0;4.0;1.8;0.0;0.0
FR;2021-02-20;18573;28855;0;0;2725157;1209981;0;0;4.1;1.8;0.0;0.0
FR;2021-02-21;3314;6403;0;0;2728471;1216384;0;0;4.1;1.8;0.0;0.0
FR;2021-02-22;37476;73947;0;0;2765947;1290331;0;0;4.1;1.9;0.0;0.0
FR;2021-02-23;53760;85804;0;0;2819707;1376135;0;0;4.2;2.1;0.0;0.0
FR;2021-02-24;59981;83169;0;0;2879688;1459304;0;0;4.3;2.2;0.0;0.0
FR;2021-02-25;100542;94257;0;0;2980230;1553561;0;0;4.4;2.3;0.0;0.0
FR;2021-02-26;113431;73721;0;0;3093661;1627282;0;0;4.6;2.4;0.0;0.0
FR;2021-02-27;52091;23352;0;0;3145752;1650634;0;0;4.7;2.5;0.0;0.0
FR;2021-02-28;6190;4481;0;0;3151942;1655115;0;0;4.7;2.5;0.0;0.0
FR;2021-03-01;65831;55071;0;0;3217773;1710186;0;0;4.8;2.5;0.0;0.0
FR;2021-03-02;101345;69518;0;0;3319118;1779704;0;0;4.9;2.7;0.0;0.0
FR;2021-03-03;116463;69082;0;0;3435581;1848786;0;0;5.1;2.8;0.0;0.0
FR;2021-03-04;163582;75704;0;0;3599163;1924490;0;0;5.4;2.9;0.0;0.0
FR;2021-03-05;200882;69765;0;0;3800045;1994255;0;0;5.7;3.0;0.0;0.0
FR;2021-03-06;207925;23031;0;0;4007970;2017286;0;0;6.0;3.0;0.0;0.0
FR;2021-03-07;121250;8297;0;0;4129220;2025583;0;0;6.2;3.0;0.0;0.0
FR;2021-03-08;107111;53776;0;0;4236331;2079359;0;0;6.3;3.1;0.0;0.0
FR;2021-03-09;172409;61897;0;0;4408740;2141256;0;0;6.6;3.2;0.0;0.0
FR;2021-03-10;178936;62713;0;0;4587676;2203969;0;0;6.8;3.3;0.0;0.0
FR;2021-03-11;242825;71474;0;0;4830501;2275443;0;0;7.2;3.4;0.0;0.0
FR;2021-03-12;294774;62772;0;0;5125275;2338215;0;0;7.6;3.5;0.0;0.0
FR;2021-03-13;231370;21309;0;0;5356645;2359524;0;0;8.0;3.5;0.0;0.0
FR;2021-03-14;63334;5334;0;0;5419979;2364858;0;0;8.1;3.5;0.0;0.0
FR;2021-03-15;158601;36770;0;0;5578580;2401628;0;0;8.3;3.6;0.0;0.0
FR;2021-03-16;141539;43211;0;0;5720119;2444839;0;0;8.5;3.6;0.0;0.0
FR;2021-03-17;150446;42934;0;0;5870565;2487773;0;0;8.7;3.7;0.0;0.0
FR;2021-03-18;167779;50017;0;0;6038344;2537790;0;0;9.0;3.8;0.0;0.0
FR;2021-03-19;229961;44512;0;0;6268305;2582302;0;0;9.3;3.8;0.0;0.0
FR;2021-03-20;166639;16199;0;0;6434944;2598501;0;0;9.6;3.9;0.0;0.0
FR;2021-03-21;49919;4277;0;0;6484863;2602778;0;0;9.7;3.9;0.0;0.0
FR;2021-03-22;169993;39440;0;0;6654856;2642218;0;0;9.9;3.9;0.0;0.0
FR;2021-03-23;250329;50155;0;0;6905185;2692373;0;0;10.3;4.0;0.0;0.0
FR;2021-03-24;256848;51731;0;0;7162033;2744104;0;0;10.7;4.1;0.0;0.0
FR;2021-03-25;341745;55803;0;0;7503778;2799907;0;0;11.2;4.2;0.0;0.0
FR;2021-03-26;358747;53567;0;0;7862525;2853474;0;0;11.7;4.3;0.0;0.0
FR;2021-03-27;195240;23150;0;0;8057765;2876624;0;0;12.0;4.3;0.0;0.0
FR;2021-03-28;59321;6066;0;0;8117086;2882690;0;0;12.1;4.3;0.0;0.0
FR;2021-03-29;202928;60683;0;0;8320014;2943373;0;0;12.4;4.4;0.0;0.0
FR;2021-03-30;285405;79975;0;0;8605419;3023348;0;0;12.8;4.5;0.0;0.0
FR;2021-03-31;262961;83832;0;0;8868380;3107180;0;0;13.2;4.6;0.0;0.0
FR;2021-04-01;315381;102703;0;0;9183761;3209883;0;0;13.7;4.8;0.0;0.0
FR;2021-04-02;281277;104497;0;0;9465038;3314380;0;0;14.1;4.9;0.0;0.0
FR;2021-04-03;141048;67136;0;0;9606086;3381516;0;0;14.3;5.0;0.0;0.0
FR;2021-04-04;46450;20774;0;0;9652536;3402290;0;0;14.4;5.1;0.0;0.0
FR;2021-04-05;63306;13447;0;0;9715842;3415737;0;0;14.5;5.1;0.0;0.0
FR;2021-04-06;217143;117932;0;0;9932985;3533669;0;0;14.8;5.3;0.0;0.0
FR;2021-04-07;260188;126632;0;0;10193173;3660301;0;0;15.2;5.5;0.0;0.0
FR;2021-04-08;337732;137200;0;0;10530905;3797501;0;0;15.7;5.7;0.0;0.0
FR;2021-04-09;410080;133606;0;0;10940985;3931107;0;0;16.3;5.9;0.0;0.0
FR;2021-04-10;212581;90974;0;0;11153566;4022081;0;0;16.6;6.0;0.0;0.0
FR;2021-04-11;56123;36941;0;0;11209689;4059022;0;0;16.7;6.0;0.0;0.0
FR;2021-04-12;236999;124731;0;0;11446688;4183753;0;0;17.1;6.2;0.0;0.0
FR;2021-04-13;309417;157350;0;0;11756105;4341103;0;0;17.5;6.5;0.0;0.0
FR;2021-04-14;294432;152564;0;0;12050537;4493667;0;0;18.0;6.7;0.0;0.0
FR;2021-04-15;337007;163767;0;0;12387544;4657434;0;0;18.5;6.9;0.0;0.0
FR;2021-04-16;339223;160445;0;0;12726767;4817879;0;0;19.0;7.2;0.0;0.0
FR;2021-04-17;188621;97658;0;0;12915388;4915537;0;0;19.2;7.3;0.0;0.0
FR;2021-04-18;51601;37782;0;0;12966989;4953319;0;0;19.3;7.4;0.0;0.0
FR;2021-04-19;205640;147257;0;0;13172629;5100576;0;0;19.6;7.6;0.0;0.0
FR;2021-04-20;254344;182387;0;0;13426973;5282963;0;0;20.0;7.9;0.0;0.0
FR;2021-04-21;253179;181003;0;0;13680152;5463966;0;0;20.4;8.1;0.0;0.0
FR;2021-04-22;287487;203222;0;0;13967639;5667188;0;0;20.8;8.4;0.0;0.0
FR;2021-04-23;297928;202430;0;0;14265567;5869618;0;0;21.3;8.7;0.0;0.0
FR;2021-04-24;190409;121953;0;0;14455976;5991571;0;0;21.5;8.9;0.0;0.0
FR;2021-04-25;69537;42496;0;0;14525513;6034067;0;0;21.6;9.0;0.0;0.0
FR;2021-04-26;220889;169380;0;0;14746402;6203447;0;0;22.0;9.2;0.0;0.0
FR;2021-04-27;284544;210559;0;0;15030946;6414006;0;0;22.4;9.6;0.0;0.0
FR;2021-04-28;299438;208244;1;0;15330384;6622250;1;0;22.8;9.9;0.0;0.0
FR;2021-04-29;357053;231524;0;0;15687437;6853774;1;0;23.4;10.2;0.0;0.0
FR;2021-04-30;372133;224087;0;0;16059570;7077861;1;0;23.9;10.5;0.0;0.0
FR;2021-05-01;167598;63723;0;0;16227168;7141584;1;0;24.2;10.6;0.0;0.0
FR;2021-05-02;91707;43452;0;0;16318875;7185036;1;0;24.3;10.7;0.0;0.0
FR;2021-05-03;288853;188892;0;0;16607728;7373928;1;0;24.7;11.0;0.0;0.0
FR;2021-05-04;315588;250446;0;0;16923316;7624374;1;0;25.2;11.4;0.0;0.0
FR;2021-05-05;327094;249710;0;0;17250410;7874084;1;0;25.7;11.7;0.0;0.0
FR;2021-05-06;379419;273576;0;0;17629829;8147660;1;0;26.3;12.1;0.0;0.0
FR;2021-05-07;372677;298259;0;0;18002506;8445919;1;0;26.8;12.6;0.0;0.0
FR;2021-05-08;222134;82551;0;0;18224640;8528470;1;0;27.2;12.7;0.0;0.0
FR;2021-05-09;129684;55017;0;0;18354324;8583487;1;0;27.3;12.8;0.0;0.0
FR;2021-05-10;313295;254405;0;0;18667619;8837892;1;0;27.8;13.2;0.0;0.0
FR;2021-05-11;403815;296179;0;0;19071434;9134071;1;0;28.4;13.6;0.0;0.0
FR;2021-05-12;434026;269235;0;0;19505460;9403306;1;0;29.1;14.0;0.0;0.0
FR;2021-05-13;338546;78403;0;0;19844006;9481709;1;0;29.6;14.1;0.0;0.0
FR;2021-05-14;454051;202747;0;0;20298057;9684456;1;0;30.2;14.4;0.0;0.0
FR;2021-05-15;374919;120384;0;0;20672976;9804840;1;0;30.8;14.6;0.0;0.0
FR;2021-05-16;202718;34173;0;0;20875694;9839013;1;0;31.1;14.7;0.0;0.0
FR;2021-05-17;376063;178556;0;0;21251757;10017569;1;0;31.7;14.9;0.0;0.0
FR;2021-05-18;460056;192206;0;0;21711813;10209775;1;0;32.4;15.2;0.0;0.0
FR;2021-05-19;467317;181983;0;0;22179130;10391758;1;0;33.0;15.5;0.0;0.0
FR;2021-05-20;507455;204139;0;0;22686585;10595897;1;0;33.8;15.8;0.0;0.0
FR;2021-05-21;489594;220841;0;0;23176179;10816738;1;0;34.5;16.1;0.0;0.0
FR;2021-05-22;347139;108269;0;0;23523318;10925007;1;0;35.0;16.3;0.0;0.0
FR;2021-05-23;161658;26874;0;0;23684976;10951881;1;0;35.3;16.3;0.0;0.0
FR;2021-05-24;263144;53013;0;0;23948120;11004894;1;0;35.7;16.4;0.0;0.0
FR;2021-05-25;400143;225631;0;0;24348263;11230525;1;0;36.3;16.7;0.0;0.0
FR;2021-05-26;413361;226449;0;0;24761624;11456974;1;0;36.9;17.1;0.0;0.0
FR;2021-05-27;449695;265635;0;0;25211319;11722609;1;0;37.6;17.5;0.0;0.0
FR;2021-05-28;429444;317414;0;0;25640763;12040023;1;0;38.2;17.9;0.0;0.0
FR;2021-05-29;298944;182140;0;0;25939707;12222163;1;0;38.6;18.2;0.0;0.0
FR;2021-05-30;107096;42158;0;0;26046803;12264321;1;0;38.8;18.3;0.0;0.0
FR;2021-05-31;357918;241593;1;0;26404721;12505914;2;0;39.3;18.6;0.0;0.0
FR;2021-06-01;430838;302784;1;0;26835559;12808698;3;0;40.0;19.1;0.0;0.0
FR;2021-06-02;419359;278088;0;0;27254918;13086786;3;0;40.6;19.5;0.0;0.0
FR;2021-06-03;464608;313054;0;0;27719526;13399840;3;0;41.3;20.0;0.0;0.0
FR;2021-06-04;455688;361973;1;0;28175214;13761813;4;0;42.0;20.5;0.0;0.0
FR;2021-06-05;304746;222130;0;0;28479960;13983943;4;0;42.4;20.8;0.0;0.0
FR;2021-06-06;133236;61277;0;0;28613196;14045220;4;0;42.6;20.9;0.0;0.0
FR;2021-06-07;339004;298964;0;0;28952200;14344184;4;0;43.1;21.4;0.0;0.0
FR;2021-06-08;393564;337753;0;0;29345764;14681937;4;0;43.7;21.9;0.0;0.0
FR;2021-06-09;384665;319819;0;0;29730429;15001756;4;0;44.3;22.4;0.0;0.0
FR;2021-06-10;403957;338304;0;0;30134386;15340060;4;0;44.9;22.9;0.0;0.0
FR;2021-06-11;386464;407532;0;0;30520850;15747592;4;0;45.5;23.5;0.0;0.0
FR;2021-06-12;283203;243386;0;0;30804053;15990978;4;0;45.9;23.8;0.0;0.0
FR;2021-06-13;104828;84992;0;0;30908881;16075970;4;0;46.1;24.0;0.0;0.0
FR;2021-06-14;240648;384615;0;0;31149529;16460585;4;0;46.4;24.5;0.0;0.0
FR;2021-06-15;307979;424289;0;0;31457508;16884874;4;0;46.9;25.2;0.0;0.0
FR;2021-06-16;313836;395488;0;0;31771344;17280362;4;0;47.3;25.7;0.0;0.0
FR;2021-06-17;317556;413572;0;0;32088900;17693934;4;0;47.8;26.4;0.0;0.0
FR;2021-06-18;321552;485747;0;0;32410452;18179681;4;0;48.3;27.1;0.0;0.0
FR;2021-06-19;224304;300938;0;0;32634756;18480619;4;0;48.6;27.5;0.0;0.0
FR;2021-06-20;74364;111781;0;0;32709120;18592400;4;0;48.7;27.7;0.0;0.0
FR;2021-06-21;195568;427776;1;0;32904688;19020176;5;0;49.0;28.3;0.0;0.0
FR;2021-06-22;223003;499927;2;0;33127691;19520103;7;0;49.4;29.1;0.0;0.0
FR;2021-06-23;233865;474022;1;0;33361556;19994125;8;0;49.7;29.8;0.0;0.0
FR;2021-06-24;241728;447088;0;0;33603284;20441213;8;0;50.1;30.5;0.0;0.0
FR;2021-06-25;227465;561197;0;0;33830749;21002410;8;0;50.4;31.3;0.0;0.0
FR;2021-06-26;153192;395474;0;0;33983941;21397884;8;0;50.6;31.9;0.0;0.0
FR;2021-06-27;55861;165124;0;0;34039802;21563008;8;0;50.7;32.1;0.0;0.0
FR;2021-06-28;154612;478407;0;0;34194414;22041415;8;0;50.9;32.8;0.0;0.0
FR;2021-06-29;182541;538274;0;0;34376955;22579689;8;0;51.2;33.6;0.0;0.0
FR;2021-06-30;203836;516861;2;0;34580791;23096550;10;0;51.5;34.4;0.0;0.0
FR;2021-07-01;231102;497916;1;0;34811893;23594466;11;0;51.9;35.2;0.0;0.0
FR;2021-07-02;228313;562677;3;0;35040206;24157143;14;0;52.2;36.0;0.0;0.0
FR;2021-07-03;141932;395310;1;0;35182138;24552453;15;0;52.4;36.6;0.0;0.0
FR;2021-07-04;56693;150968;0;0;35238831;24703421;15;0;52.5;36.8;0.0;0.0
FR;2021-07-05;168221;449375;2;0;35407052;25152796;17;0;52.8;37.5;0.0;0.0
FR;2021-07-06;196554;511524;8;0;35603606;25664320;25;0;53.0;38.2;0.0;0.0
FR;2021-07-07;212929;477912;5;0;35816535;26142232;30;0;53.4;39.0;0.0;0.0
FR;2021-07-08;231440;468305;7;0;36047975;26610537;37;0;53.7;39.6;0.0;0.0
FR;2021-07-09;228341;557201;2;0;36276316;27167738;39;0;54.1;40.5;0.0;0.0
FR;2021-07-10;148531;368908;1;0;36424847;27536646;40;0;54.3;41.0;0.0;0.0
FR;2021-07-11;60141;121098;0;0;36484988;27657744;40;0;54.4;41.2;0.0;0.0
FR;2021-07-12;168956;513153;0;0;36653944;28170897;40;0;54.6;42.0;0.0;0.0
FR;2021-07-13;287061;586738;2;0;36941005;28757635;42;0;55.0;42.8;0.0;0.0
FR;2021-07-14;180892;187147;0;0;37121897;28944782;42;0;55.3;43.1;0.0;0.0
FR;2021-07-15;346867;572760;0;0;37468764;29517542;42;0;55.8;44.0;0.0;0.0
FR;2021-07-16;379903;575414;1;0;37848667;30092956;43;0;56.4;44.8;0.0;0.0
FR;2021-07-17;259650;368944;0;0;38108317;30461900;43;0;56.8;45.4;0.0;0.0
FR;2021-07-18;109666;133306;0;0;38217983;30595206;43;0;56.9;45.6;0.0;0.0
FR;2021-07-19;285313;480223;0;0;38503296;31075429;43;0;57.4;46.3;0.0;0.0
FR;2021-07-20;376723;524956;0;0;38880019;31600385;43;0;57.9;47.1;0.0;0.0
FR;2021-07-21;395626;483115;2;0;39275645;32083500;45;0;58.5;47.8;0.0;0.0
FR;2021-07-22;440877;472816;2;0;39716522;32556316;47;0;59.2;48.5;0.0;0.0
FR;2021-07-23;439849;511373;2;0;40156371;33067689;49;0;59.8;49.3;0.0;0.0
FR;2021-07-24;285180;322365;0;0;40441551;33390054;49;0;60.3;49.8;0.0;0.0
FR;2021-07-25;121051;100466;0;0;40562602;33490520;49;0;60.4;49.9;0.0;0.0
FR;2021-07-26;347266;385964;2;0;40909868;33876484;51;0;61.0;50.5;0.0;0.0
FR;2021-07-27;463885;401662;2;0;41373753;34278146;53;0;61.6;51.1;0.0;0.0
FR;2021-07-28;459295;367888;2;0;41833048;34646034;55;0;62.3;51.6;0.0;0.0
FR;2021-07-29;489678;358071;1;0;42322726;35004105;56;0;63.1;52.2;0.0;0.0
FR;2021-07-30;461632;381643;2;0;42784358;35385748;58;0;63.7;52.7;0.0;0.0
FR;2021-07-31;285339;231695;0;0;43069697;35617443;58;0;64.2;53.1;0.0;0.0
FR;2021-08-01;111935;65828;0;0;43181632;35683271;58;0;64.3;53.2;0.0;0.0
FR;2021-08-02;341209;285553;0;0;43522841;35968824;58;0;64.8;53.6;0.0;0.0
FR;2021-08-03;398404;305444;1;0;43921245;36274268;59;0;65.4;54.0;0.0;0.0
FR;2021-08-04;384630;266502;3;0;44305875;36540770;62;0;66.0;54.4;0.0;0.0
FR;2021-08-05;365973;282628;0;0;44671848;36823398;62;0;66.6;54.9;0.0;0.0
FR;2021-08-06;359555;327399;1;0;45031403;37150797;63;0;67.1;55.4;0.0;0.0
FR;2021-08-07;213035;210263;3;0;45244438;37361060;66;0;67.4;55.7;0.0;0.0
FR;2021-08-08;74131;73741;0;0;45318569;37434801;66;0;67.5;55.8;0.0;0.0
FR;2021-08-09;258575;298675;3;0;45577144;37733476;69;0;67.9;56.2;0.0;0.0
FR;2021-08-10;306600;324693;1;0;45883744;38058169;70;0;68.4;56.7;0.0;0.0
FR;2021-08-11;279524;302631;1;0;46163268;38360800;71;0;68.8;57.2;0.0;0.0
FR;2021-08-12;271373;321197;1;0;46434641;38681997;72;0;69.2;57.6;0.0;0.0
FR;2021-08-13;252034;317033;2;0;46686675;38999030;74;0;69.6;58.1;0.0;0.0
FR;2021-08-14;145276;219417;0;0;46831951;39218447;74;0;69.8;58.4;0.0;0.0
FR;2021-08-15;39303;55733;0;0;46871254;39274180;74;0;69.8;58.5;0.0;0.0
FR;2021-08-16;186041;346333;0;0;47057295;39620513;74;0;70.1;59.0;0.0;0.0
FR;2021-08-17;215554;369932;1;0;47272849;39990445;75;0;70.4;59.6;0.0;0.0
FR;2021-08-18;198925;355271;4;0;47471774;40345716;79;0;70.7;60.1;0.0;0.0
FR;2021-08-19;191889;356629;0;0;47663663;40702345;79;0;71.0;60.6;0.0;0.0
FR;2021-08-20;186345;397157;2;0;47850008;41099502;81;0;71.3;61.2;0.0;0.0
FR;2021-08-21;104751;254748;0;0;47954759;41354250;81;0;71.5;61.6;0.0;0.0
FR;2021-08-22;31887;92212;1;0;47986646;41446462;82;0;71.5;61.8;0.0;0.0
FR;2021-08-23;140886;380210;2;0;48127532;41826672;84;0;71.7;62.3;0.0;0.0
FR;2021-08-24;162403;403576;1;0;48289935;42230248;85;0;72.0;62.9;0.0;0.0
FR;2021-08-25;151057;376047;3;0;48440992;42606295;88;0;72.2;63.5;0.0;0.0
FR;2021-08-26;142736;368342;1;0;48583728;42974637;89;0;72.4;64.0;0.0;0.0
FR;2021-08-27;148362;415574;3;0;48732090;43390211;92;0;72.6;64.7;0.0;0.0
FR;2021-08-28;90604;265286;0;0;48822694;43655497;92;0;72.7;65.0;0.0;0.0
FR;2021-08-29;27305;88398;0;0;48849999;43743895;92;0;72.8;65.2;0.0;0.0
FR;2021-08-30;117321;342654;6026;1;48967320;44086549;6118;1;73.0;65.7;0.0;0.0
FR;2021-08-31;128715;354215;11881;2;49096035;44440764;17999;3;73.2;66.2;0.0;0.0
FR;2021-09-01;135743;302706;24309;1;49231778;44743470;42308;4;73.4;66.7;0.1;0.0
FR;2021-09-02;112594;262479;28869;1;49344372;45005949;71177;5;73.5;67.1;0.1;0.0
FR;2021-09-03;118193;309699;32959;6;49462565;45315648;104136;11;73.7;67.5;0.2;0.0
FR;2021-09-04;89796;230675;14071;5;49552361;45546323;118207;16;73.8;67.9;0.2;0.0
FR;2021-09-05;21336;48362;4731;0;49573697;45594685;122938;16;73.9;67.9;0.2;0.0
FR;2021-09-06;75322;191205;34241;2;49649019;45785890;157179;18;74.0;68.2;0.2;0.0
FR;2021-09-07;80085;191501;36098;3;49729104;45977391;193277;21;74.1;68.5;0.3;0.0
FR;2021-09-08;89744;216951;32452;6;49818848;46194342;225729;27;74.2;68.8;0.3;0.0
FR;2021-09-09;76660;174520;36524;16;49895508;46368862;262253;43;74.3;69.1;0.4;0.0
FR;2021-09-10;95593;215246;40520;13;49991101;46584108;302773;56;74.5;69.4;0.5;0.0
FR;2021-09-11;66739;178302;14310;1;50057840;46762410;317083;57;74.6;69.7;0.5;0.0
FR;2021-09-12;12793;34160;3160;2;50070633;46796570;320243;59;74.6;69.7;0.5;0.0
FR;2021-09-13;64368;134676;44046;29;50135001;46931246;364289;88;74.7;69.9;0.5;0.0
FR;2021-09-14;73312;136299;62027;52;50208313;47067545;426316;140;74.8;70.1;0.6;0.0
FR;2021-09-15;76405;174883;54774;99;50284718;47242428;481090;239;74.9;70.4;0.7;0.0
FR;2021-09-16;63757;117981;60014;126;50348475;47360409;541104;365;75.0;70.6;0.8;0.0
FR;2021-09-17;74963;159835;57233;93;50423438;47520244;598337;458;75.1;70.8;0.9;0.0
FR;2021-09-18;48187;144336;17283;24;50471625;47664580;615620;482;75.2;71.0;0.9;0.0
FR;2021-09-19;7866;24929;2619;3;50479491;47689509;618239;485;75.2;71.1;0.9;0.0
FR;2021-09-20;44444;96446;50252;56;50523935;47785955;668491;541;75.3;71.2;1.0;0.0
FR;2021-09-21;45807;98508;63368;127;50569742;47884463;731859;668;75.3;71.3;1.1;0.0
FR;2021-09-22;48586;144830;55345;68;50618328;48029293;787204;736;75.4;71.6;1.2;0.0
FR;2021-09-23;43162;91252;63471;121;50661490;48120545;850675;857;75.5;71.7;1.3;0.0
FR;2021-09-24;52203;132455;59089;104;50713693;48253000;909764;961;75.6;71.9;1.4;0.0
FR;2021-09-25;35191;118559;18253;27;50748884;48371559;928017;988;75.6;72.1;1.4;0.0
FR;2021-09-26;5524;18689;2329;5;50754408;48390248;930346;993;75.6;72.1;1.4;0.0
FR;2021-09-27;33920;78888;48124;113;50788328;48469136;978470;1106;75.7;72.2;1.5;0.0
FR;2021-09-28;36444;74411;56461;82;50824772;48543547;1034931;1188;75.7;72.3;1.5;0.0
FR;2021-09-29;44312;103038;54808;77;50869084;48646585;1089739;1265;75.8;72.5;1.6;0.0
FR;2021-09-30;36269;71391;59474;85;50905353;48717976;1149213;1350;75.8;72.6;1.7;0.0
FR;2021-10-01;61521;99693;63680;54;50966874;48817669;1212893;1404;75.9;72.7;1.8;0.0
FR;2021-10-02;39413;81686;23316;18;51006287;48899355;1236209;1422;76.0;72.9;1.8;0.0
FR;2021-10-03;5261;11290;2540;4;51011548;48910645;1238749;1426;76.0;72.9;1.8;0.0
FR;2021-10-04;34955;59569;54777;82;51046503;48970214;1293526;1508;76.1;73.0;1.9;0.0
FR;2021-10-05;33559;62208;64914;73;51080062;49032422;1358440;1581;76.1;73.1;2.0;0.0
FR;2021-10-06;42422;80222;68225;42;51122484;49112644;1426665;1623;76.2;73.2;2.1;0.0
FR;2021-10-07;30393;59467;68661;87;51152877;49172111;1495326;1710;76.2;73.3;2.2;0.0
FR;2021-10-08;48745;89890;84613;69;51201622;49262001;1579939;1779;76.3;73.4;2.4;0.0
FR;2021-10-09;33621;64136;33854;20;51235243;49326137;1613793;1799;76.3;73.5;2.4;0.0
FR;2021-10-10;4589;7931;3483;2;51239832;49334068;1617276;1801;76.3;73.5;2.4;0.0
FR;2021-10-11;30559;50656;64019;94;51270391;49384724;1681295;1895;76.4;73.6;2.5;0.0
FR;2021-10-12;31344;51435;75828;58;51301735;49436159;1757123;1953;76.4;73.7;2.6;0.0
FR;2021-10-13;39986;62838;79246;51;51341721;49498997;1836369;2004;76.5;73.8;2.7;0.0
FR;2021-10-14;30227;49762;73756;49;51371948;49548759;1910125;2053;76.5;73.8;2.8;0.0
FR;2021-10-15;44734;70460;102892;59;51416682;49619219;2013017;2112;76.6;73.9;3.0;0.0
FR;2021-10-16;31269;46726;39605;24;51447951;49665945;2052622;2136;76.7;74.0;3.1;0.0
FR;2021-10-17;3827;5695;3691;3;51451778;49671640;2056313;2139;76.7;74.0;3.1;0.0
FR;2021-10-18;28295;42673;71332;36;51480073;49714313;2127645;2175;76.7;74.1;3.2;0.0
FR;2021-10-19;27050;42205;81603;71;51507123;49756518;2209248;2246;76.7;74.1;3.3;0.0
FR;2021-10-20;35202;51887;101459;93;51542325;49808405;2310707;2339;76.8;74.2;3.4;0.0
FR;2021-10-21;25941;42016;89106;45;51568266;49850421;2399813;2384;76.8;74.3;3.6;0.0
FR;2021-10-22;38204;59330;112475;91;51606470;49909751;2512288;2475;76.9;74.4;3.7;0.0
FR;2021-10-23;26969;42454;48595;24;51633439;49952205;2560883;2499;76.9;74.4;3.8;0.0
FR;2021-10-24;2912;5022;3937;3;51636351;49957227;2564820;2502;76.9;74.4;3.8;0.0
FR;2021-10-25;25971;35638;86597;67;51662322;49992865;2651417;2569;77.0;74.5;4.0;0.0
FR;2021-10-26;23682;32299;92311;48;51686004;50025164;2743728;2617;77.0;74.5;4.1;0.0
FR;2021-10-27;30006;44205;114610;73;51716010;50069369;2858338;2690;77.1;74.6;4.3;0.0
FR;2021-10-28;23381;31210;94381;62;51739391;50100579;2952719;2752;77.1;74.6;4.4;0.0
FR;2021-10-29;31503;46524;125242;80;51770894;50147103;3077961;2832;77.1;74.7;4.6;0.0
FR;2021-10-30;20523;32842;53355;27;51791417;50179945;3131316;2859;77.2;74.8;4.7;0.0
FR;2021-10-31;2478;3874;3868;3;51793895;50183819;3135184;2862;77.2;74.8;4.7;0.0
FR;2021-11-01;8195;4961;3555;10;51802090;50188780;3138739;2872;77.2;74.8;4.7;0.0
FR;2021-11-02;25282;36350;99465;63;51827372;50225130;3238204;2935;77.2;74.8;4.8;0.0
FR;2021-11-03;29758;43601;125782;96;51857130;50268731;3363986;3031;77.3;74.9;5.0;0.0
FR;2021-11-04;23662;31634;114318;68;51880792;50300365;3478304;3099;77.3;74.9;5.2;0.0
FR;2021-11-05;32268;44708;151252;84;51913060;50345073;3629556;3183;77.3;75.0;5.4;0.0
FR;2021-11-06;21478;32458;68224;40;51934538;50377531;3697780;3223;77.4;75.1;5.5;0.0
FR;2021-11-07;2378;4058;5582;8;51936916;50381589;3703362;3231;77.4;75.1;5.5;0.0
FR;2021-11-08;20402;31078;134150;73;51957318;50412667;3837512;3304;77.4;75.1;5.7;0.0
FR;2021-11-09;22130;33102;172103;107;51979448;50445769;4009615;3411;77.4;75.2;6.0;0.0
FR;2021-11-10;31368;44237;198668;128;52010816;50490006;4208283;3539;77.5;75.2;6.3;0.0
FR;2021-11-11;4311;5858;13922;20;52015127;50495864;4222205;3559;77.5;75.2;6.3;0.0
FR;2021-11-12;28989;41891;197254;126;52044116;50537755;4419459;3685;77.5;75.3;6.6;0.0
FR;2021-11-13;20295;28357;86289;60;52064411;50566112;4505748;3745;77.6;75.3;6.7;0.0
FR;2021-11-14;2331;3408;7878;10;52066742;50569520;4513626;3755;77.6;75.3;6.7;0.0
FR;2021-11-15;20301;28067;171442;102;52087043;50597587;4685068;3857;77.6;75.4;7.0;0.0
FR;2021-11-16;23343;28003;214866;152;52110386;50625590;4899934;4009;77.6;75.4;7.3;0.0
FR;2021-11-17;30349;36715;212784;132;52140735;50662305;5112718;4141;77.7;75.5;7.6;0.0
FR;2021-11-18;23346;28819;205394;123;52164081;50691124;5318112;4264;77.7;75.5;7.9;0.0
FR;2021-11-19;33554;40091;262063;185;52197635;50731215;5580175;4449;77.8;75.6;8.3;0.0
FR;2021-11-20;25322;29400;109660;63;52222957;50760615;5689835;4512;77.8;75.6;8.5;0.0
FR;2021-11-21;2623;3482;10643;17;52225580;50764097;5700478;4529;77.8;75.6;8.5;0.0
FR;2021-11-22;22739;19170;194750;85;52248319;50783267;5895228;4614;77.8;75.7;8.8;0.0
FR;2021-11-23;25562;24456;247721;82;52273881;50807723;6142949;4696;77.9;75.7;9.2;0.0
FR;2021-11-24;31761;34772;243117;80;52305642;50842495;6386066;4776;77.9;75.8;9.5;0.0
FR;2021-11-25;25383;25194;277559;111;52331025;50867689;6663625;4887;78.0;75.8;9.9;0.0
FR;2021-11-26;33203;37586;414497;160;52364228;50905275;7078122;5047;78.0;75.8;10.5;0.0
FR;2021-11-27;23302;28648;236558;148;52387530;50933923;7314680;5195;78.1;75.9;10.9;0.0
FR;2021-11-28;3479;4128;63329;41;52391009;50938051;7378009;5236;78.1;75.9;11.0;0.0
FR;2021-11-29;19385;23457;371542;175;52410394;50961508;7749551;5411;78.1;75.9;11.5;0.0
FR;2021-11-30;24729;27259;500636;280;52435123;50988767;8250187;5691;78.1;76.0;12.3;0.0
FR;2021-12-01;26880;31868;511172;300;52462003;51020635;8761359;5991;78.2;76.0;13.1;0.0
FR;2021-12-02;21977;21382;574689;302;52483980;51042017;9336048;6293;78.2;76.1;13.9;0.0
FR;2021-12-03;25475;34146;650967;325;52509455;51076163;9987015;6618;78.2;76.1;14.9;0.0
FR;2021-12-04;18287;25912;369684;216;52527742;51102075;10356699;6834;78.3;76.1;15.4;0.0
FR;2021-12-05;4142;4965;107053;94;52531884;51107040;10463752;6928;78.3;76.1;15.6;0.0
FR;2021-12-06;22856;25750;539817;383;52554740;51132790;11003569;7311;78.3;76.2;16.4;0.0
FR;2021-12-07;23312;29173;706134;407;52578052;51161963;11709703;7718;78.3;76.2;17.4;0.0
FR;2021-12-08;25337;35442;647321;435;52603389;51197405;12357024;8153;78.4;76.3;18.4;0.0
FR;2021-12-09;23995;29497;726170;454;52627384;51226902;13083194;8607;78.4;76.3;19.5;0.0
FR;2021-12-10;27693;38317;805966;461;52655077;51265219;13889160;9068;78.5;76.4;20.7;0.0
FR;2021-12-11;20222;29942;480327;353;52675299;51295161;14369487;9421;78.5;76.4;21.4;0.0
FR;2021-12-12;5624;6464;159227;107;52680923;51301625;14528714;9528;78.5;76.4;21.6;0.0
FR;2021-12-13;21062;30180;649185;393;52701985;51331805;15177899;9921;78.5;76.5;22.6;0.0
FR;2021-12-14;27574;35844;847352;681;52729559;51367649;16025251;10602;78.6;76.5;23.9;0.0
FR;2021-12-15;28205;39922;768909;491;52757764;51407571;16794160;11093;78.6;76.6;25.0;0.0
FR;2021-12-16;27938;35608;844262;504;52785702;51443179;17638422;11597;78.6;76.6;26.3;0.0
FR;2021-12-17;31544;43773;891982;593;52817246;51486952;18530404;12190;78.7;76.7;27.6;0.0
FR;2021-12-18;24912;30241;522143;365;52842158;51517193;19052547;12555;78.7;76.8;28.4;0.0
FR;2021-12-19;8741;7971;191144;140;52850899;51525164;19243691;12695;78.7;76.8;28.7;0.0
FR;2021-12-20;31588;34244;658594;488;52882487;51559408;19902285;13183;78.8;76.8;29.7;0.0
FR;2021-12-21;39215;39247;759458;578;52921702;51598655;20661743;13761;78.9;76.9;30.8;0.0
FR;2021-12-22;39459;37477;642026;702;52961161;51636132;21303769;14463;78.9;76.9;31.7;0.0
FR;2021-12-23;33742;30385;494322;592;52994903;51666517;21798091;15055;79.0;77.0;32.5;0.0
FR;2021-12-24;10664;11614;126641;240;53005567;51678131;21924732;15295;79.0;77.0;32.7;0.0
FR;2021-12-25;768;1937;9026;72;53006335;51680068;21933758;15367;79.0;77.0;32.7;0.0
FR;2021-12-26;4696;4766;60129;169;53011031;51684834;21993887;15536;79.0;77.0;32.8;0.0
FR;2021-12-27;30375;33159;509085;673;53041406;51717993;22502972;16209;79.0;77.1;33.5;0.0
FR;2021-12-28;38308;35307;632156;1555;53079714;51753300;23135128;17764;79.1;77.1;34.5;0.0
FR;2021-12-29;39843;33283;560915;1751;53119557;51786583;23696043;19515;79.1;77.2;35.3;0.0
FR;2021-12-30;35885;29453;471098;1881;53155442;51816036;24167141;21396;79.2;77.2;36.0;0.0
FR;2021-12-31;12035;11339;131617;755;53167477;51827375;24298758;22151;79.2;77.2;36.2;0.0
FR;2022-01-01;1324;1764;9928;100;53168801;51829139;24308686;22251;79.2;77.2;36.2;0.0
FR;2022-01-02;6075;5083;66930;408;53174876;51834222;24375616;22659;79.2;77.2;36.3;0.0
FR;2022-01-03;32639;36618;551478;2642;53207515;51870840;24927094;25301;79.3;77.3;37.1;0.0
FR;2022-01-04;40894;40499;714214;3839;53248409;51911339;25641308;29140;79.3;77.3;38.2;0.0
FR;2022-01-05;60323;43404;634055;3436;53308732;51954743;26275363;32576;79.4;77.4;39.1;0.0
FR;2022-01-06;43942;40062;711317;4563;53352674;51994805;26986680;37139;79.5;77.5;40.2;0.1
FR;2022-01-07;50552;46586;790327;5005;53403226;52041391;27777007;42144;79.6;77.5;41.4;0.1
FR;2022-01-08;44952;35014;472843;2443;53448178;52076405;28249850;44587;79.6;77.6;42.1;0.1
FR;2022-01-09;15596;11490;145697;830;53463774;52087895;28395547;45417;79.7;77.6;42.3;0.1
FR;2022-01-10;35020;38540;522181;3719;53498794;52126435;28917728;49136;79.7;77.7;43.1;0.1
FR;2022-01-11;41647;42046;608386;5215;53540441;52168481;29526114;54351;79.8;77.7;44.0;0.1
FR;2022-01-12;60153;49222;504226;4492;53600594;52217703;30030340;58843;79.9;77.8;44.7;0.1
FR;2022-01-13;37908;40300;540945;5461;53638502;52258003;30571285;64304;79.9;77.9;45.6;0.1
FR;2022-01-14;42385;43345;628955;6460;53680887;52301348;31200240;70764;80.0;77.9;46.5;0.1
FR;2022-01-15;39305;31287;377538;3293;53720192;52332635;31577778;74057;80.0;78.0;47.1;0.1
FR;2022-01-16;11381;9014;99442;760;53731573;52341649;31677220;74817;80.1;78.0;47.2;0.1
FR;2022-01-17;24600;28027;354119;3961;53756173;52369676;32031339;78778;80.1;78.0;47.7;0.1
FR;2022-01-18;28103;31763;397503;5774;53784276;52401439;32428842;84552;80.1;78.1;48.3;0.1
FR;2022-01-19;43042;40269;311043;4385;53827318;52441708;32739885;88937;80.2;78.1;48.8;0.1
FR;2022-01-20;23414;29329;328414;5627;53850732;52471037;33068299;94564;80.2;78.2;49.3;0.1
FR;2022-01-21;27988;32966;401123;6583;53878720;52504003;33469422;101147;80.3;78.2;49.9;0.2
FR;2022-01-22;27607;27165;241741;2842;53906327;52531168;33711163;103989;80.3;78.3;50.2;0.2
FR;2022-01-23;6702;7513;55181;590;53913029;52538681;33766344;104579;80.3;78.3;50.3;0.2
FR;2022-01-24;16195;25053;239310;4095;53929224;52563734;34005654;108674;80.4;78.3;50.7;0.2
FR;2022-01-25;18904;28579;267033;6066;53948128;52592313;34272687;114740;80.4;78.4;51.1;0.2
FR;2022-01-26;28110;41041;229340;4474;53976238;52633354;34502027;119214;80.4;78.4;51.4;0.2
FR;2022-01-27;16274;25713;225810;5693;53992512;52659067;34727837;124907;80.4;78.5;51.7;0.2
FR;2022-01-28;21497;41811;321449;7410;54014009;52700878;35049286;132317;80.5;78.5;52.2;0.2
FR;2022-01-29;18401;32672;204572;3249;54032410;52733550;35253858;135566;80.5;78.6;52.5;0.2
FR;2022-01-30;4466;9155;45089;639;54036876;52742705;35298947;136205;80.5;78.6;52.6;0.2
FR;2022-01-31;11220;25954;164777;4243;54048096;52768659;35463724;140448;80.5;78.6;52.8;0.2
FR;2022-02-01;12809;27100;191359;7099;54060905;52795759;35655083;147547;80.5;78.7;53.1;0.2
FR;2022-02-02;20027;45667;190117;5992;54080932;52841426;35845200;153539;80.6;78.7;53.4;0.2
FR;2022-02-03;10959;24625;173292;6967;54091891;52866051;36018492;160506;80.6;78.8;53.7;0.2
FR;2022-02-04;14486;35937;264166;9206;54106377;52901988;36282658;169712;80.6;78.8;54.1;0.3
FR;2022-02-05;12782;31919;172332;3816;54119159;52933907;36454990;173528;80.6;78.9;54.3;0.3
FR;2022-02-06;2705;7325;33825;663;54121864;52941232;36488815;174191;80.6;78.9;54.4;0.3
FR;2022-02-07;9328;24424;176310;5290;54131192;52965656;36665125;179481;80.7;78.9;54.6;0.3
FR;2022-02-08;9592;20526;184322;7049;54140784;52986182;36849447;186530;80.7;78.9;54.9;0.3
FR;2022-02-09;14161;34961;192955;5778;54154945;53021143;37042402;192308;80.7;79.0;55.2;0.3
FR;2022-02-10;8264;17865;166576;6496;54163209;53039008;37208978;198804;80.7;79.0;55.4;0.3
FR;2022-02-11;10757;25601;243000;8324;54173966;53064609;37451978;207128;80.7;79.1;55.8;0.3
FR;2022-02-12;8347;22551;151704;3502;54182313;53087160;37603682;210630;80.7;79.1;56.0;0.3
FR;2022-02-13;1895;4390;30903;540;54184208;53091550;37634585;211170;80.7;79.1;56.1;0.3
FR;2022-02-14;6905;14503;166304;4774;54191113;53106053;37800889;215944;80.7;79.1;56.3;0.3
FR;2022-02-15;6851;15243;162437;6846;54197964;53121296;37963326;222790;80.8;79.1;56.6;0.3
FR;2022-02-16;9291;25600;146646;5720;54207255;53146896;38109972;228510;80.8;79.2;56.8;0.3
FR;2022-02-17;5368;12558;94758;5403;54212623;53159454;38204730;233913;80.8;79.2;56.9;0.3
FR;2022-02-18;6876;18420;129241;7399;54219499;53177874;38333971;241312;80.8;79.2;57.1;0.4
FR;2022-02-19;5341;15801;77300;3016;54224840;53193675;38411271;244328;80.8;79.3;57.2;0.4
FR;2022-02-20;1135;2882;13925;459;54225975;53196557;38425196;244787;80.8;79.3;57.3;0.4
FR;2022-02-21;4021;10038;67136;4057;54229996;53206595;38492332;248844;80.8;79.3;57.4;0.4
FR;2022-02-22;4370;11097;64406;5249;54234366;53217692;38556738;254093;80.8;79.3;57.4;0.4
FR;2022-02-23;6509;19385;71858;4590;54240875;53237077;38628596;258683;80.8;79.3;57.6;0.4
FR;2022-02-24;3745;9126;53180;4530;54244620;53246203;38681776;263213;80.8;79.3;57.6;0.4
FR;2022-02-25;5199;14523;79996;7327;54249819;53260726;38761772;270540;80.8;79.4;57.8;0.4
FR;2022-02-26;3970;12036;51453;3083;54253789;53272762;38813225;273623;80.8;79.4;57.8;0.4
FR;2022-02-27;870;1956;8932;529;54254659;53274718;38822157;274152;80.8;79.4;57.8;0.4
FR;2022-02-28;3068;7222;42874;3850;54257727;53281940;38865031;278002;80.8;79.4;57.9;0.4
FR;2022-03-01;3128;7278;44762;5509;54260855;53289218;38909793;283511;80.8;79.4;58.0;0.4
FR;2022-03-02;5076;12513;48987;4921;54265931;53301731;38958780;288432;80.9;79.4;58.0;0.4
FR;2022-03-03;2649;5802;29921;4043;54268580;53307533;38988701;292475;80.9;79.4;58.1;0.4
FR;2022-03-04;3175;8185;39385;6208;54271755;53315718;39028086;298683;80.9;79.4;58.2;0.4
FR;2022-03-05;2919;7058;25074;3130;54274674;53322776;39053160;301813;80.9;79.4;58.2;0.4
FR;2022-03-06;509;1011;3429;378;54275183;53323787;39056589;302191;80.9;79.5;58.2;0.5
FR;2022-03-07;1939;3696;17651;3298;54277122;53327483;39074240;305489;80.9;79.5;58.2;0.5
FR;2022-03-08;1967;4147;17859;4089;54279089;53331630;39092099;309578;80.9;79.5;58.2;0.5
FR;2022-03-09;3447;8510;21222;4029;54282536;53340140;39113321;313607;80.9;79.5;58.3;0.5
FR;2022-03-10;1710;3783;15680;3394;54284246;53343923;39129001;317001;80.9;79.5;58.3;0.5
FR;2022-03-11;2342;5173;22222;5468;54286588;53349096;39151223;322469;80.9;79.5;58.3;0.5
FR;2022-03-12;2656;5426;16498;3132;54289244;53354522;39167721;325601;80.9;79.5;58.4;0.5
FR;2022-03-13;385;589;2253;529;54289629;53355111;39169974;326130;80.9;79.5;58.4;0.5
FR;2022-03-14;1460;2674;13784;7280;54291089;53357785;39183758;333410;80.9;79.5;58.4;0.5
FR;2022-03-15;1593;3000;14330;11012;54292682;53360785;39198088;344422;80.9;79.5;58.4;0.5
FR;2022-03-16;2941;5849;18017;16285;54295623;53366634;39216105;360707;80.9;79.5;58.4;0.5
FR;2022-03-17;1370;2504;11933;13294;54296993;53369138;39228038;374001;80.9;79.5;58.4;0.6
FR;2022-03-18;2197;3860;18019;22011;54299190;53372998;39246057;396012;80.9;79.5;58.5;0.6
FR;2022-03-19;2274;3996;12398;11402;54301464;53376994;39258455;407414;80.9;79.5;58.5;0.6
FR;2022-03-20;292;501;1916;1332;54301756;53377495;39260371;408746;80.9;79.5;58.5;0.6
FR;2022-03-21;1341;2058;11908;16898;54303097;53379553;39272279;425644;80.9;79.5;58.5;0.6
FR;2022-03-22;1460;2421;12510;22811;54304557;53381974;39284789;448455;80.9;79.5;58.5;0.7
FR;2022-03-23;2633;5003;17144;25241;54307190;53386977;39301933;473696;80.9;79.5;58.6;0.7
FR;2022-03-24;1356;2011;10613;19350;54308546;53388988;39312546;493046;80.9;79.5;58.6;0.7
FR;2022-03-25;2045;3329;16820;30775;54310591;53392317;39329366;523821;80.9;79.6;58.6;0.8
FR;2022-03-26;2215;3692;11496;14378;54312806;53396009;39340862;538199;80.9;79.6;58.6;0.8
FR;2022-03-27;354;501;1908;1730;54313160;53396510;39342770;539929;80.9;79.6;58.6;0.8
FR;2022-03-28;1410;1955;10541;19025;54314570;53398465;39353311;558954;80.9;79.6;58.6;0.8
FR;2022-03-29;1419;2023;12005;29229;54315989;53400488;39365316;588183;80.9;79.6;58.7;0.9
FR;2022-03-30;2810;4545;14991;29250;54318799;53405033;39380307;617433;80.9;79.6;58.7;0.9
FR;2022-03-31;1589;2116;12185;26477;54320388;53407149;39392492;643910;80.9;79.6;58.7;1.0
FR;2022-04-01;2082;2651;18591;33405;54322470;53409800;39411083;677315;80.9;79.6;58.7;1.0
FR;2022-04-02;1491;1967;8686;11266;54323961;53411767;39419769;688581;80.9;79.6;58.7;1.0
FR;2022-04-03;273;338;1570;1378;54324234;53412105;39421339;689959;80.9;79.6;58.7;1.0
FR;2022-04-04;1319;1559;11353;20521;54325553;53413664;39432692;710480;80.9;79.6;58.8;1.1
FR;2022-04-05;1579;1795;13078;35586;54327132;53415459;39445770;746066;80.9;79.6;58.8;1.1
FR;2022-04-06;2027;2680;12652;27773;54329159;53418139;39458422;773839;80.9;79.6;58.8;1.2
FR;2022-04-07;1420;1691;12775;34941;54330579;53419830;39471197;808780;81.0;79.6;58.8;1.2
FR;2022-04-08;2009;2395;17723;45995;54332588;53422225;39488920;854775;81.0;79.6;58.8;1.3
FR;2022-04-09;1341;1868;8835;14769;54333929;53424093;39497755;869544;81.0;79.6;58.9;1.3
FR;2022-04-10;271;364;1971;2254;54334200;53424457;39499726;871798;81.0;79.6;58.9;1.3
FR;2022-04-11;1173;1468;11404;24899;54335373;53425925;39511130;896697;81.0;79.6;58.9;1.3
FR;2022-04-12;1559;1652;13253;41434;54336932;53427577;39524383;938131;81.0;79.6;58.9;1.4
FR;2022-04-13;1836;2399;12878;33724;54338768;53429976;39537261;971855;81.0;79.6;58.9;1.4
FR;2022-04-14;1431;1584;12846;36565;54340199;53431560;39550107;1008420;81.0;79.6;58.9;1.5
FR;2022-04-15;1767;2050;14716;36861;54341966;53433610;39564823;1045281;81.0;79.6;59.0;1.6
FR;2022-04-16;1025;1231;6211;9404;54342991;53434841;39571034;1054685;81.0;79.6;59.0;1.6
FR;2022-04-17;183;199;1027;1223;54343174;53435040;39572061;1055908;81.0;79.6;59.0;1.6
FR;2022-04-18;144;231;2741;1247;54343318;53435271;39574802;1057155;81.0;79.6;59.0;1.6
FR;2022-04-19;1459;1739;12336;30448;54344777;53437010;39587138;1087603;81.0;79.6;59.0;1.6
FR;2022-04-20;1887;2417;12798;29725;54346664;53439427;39599936;1117328;81.0;79.6;59.0;1.7
FR;2022-04-21;1466;1681;12412;35288;54348130;53441108;39612348;1152616;81.0;79.6;59.0;1.7
FR;2022-04-22;1812;2211;15731;38869;54349942;53443319;39628079;1191485;81.0;79.6;59.0;1.8
FR;2022-04-23;1112;1441;7196;11416;54351054;53444760;39635275;1202901;81.0;79.6;59.1;1.8
FR;2022-04-24;236;302;1401;1835;54351290;53445062;39636676;1204736;81.0;79.6;59.1;1.8
FR;2022-04-25;1241;1501;10397;21830;54352531;53446563;39647073;1226566;81.0;79.6;59.1;1.8
FR;2022-04-26;1545;1867;12987;38921;54354076;53448430;39660060;1265487;81.0;79.6;59.1;1.9
FR;2022-04-27;1896;2196;11453;30950;54355972;53450626;39671513;1296437;81.0;79.6;59.1;1.9
FR;2022-04-28;1515;1695;12096;35963;54357487;53452321;39683609;1332400;81.0;79.6;59.1;2.0
FR;2022-04-29;1937;2212;14691;38256;54359424;53454533;39698300;1370656;81.0;79.6;59.1;2.0
FR;2022-04-30;1176;1260;6566;10525;54360600;53455793;39704866;1381181;81.0;79.6;59.2;2.1
FR;2022-05-01;169;200;872;1084;54360769;53455993;39705738;1382265;81.0;79.6;59.2;2.1
FR;2022-05-02;1127;1245;10430;18596;54361896;53457238;39716168;1400861;81.0;79.7;59.2;2.1
FR;2022-05-03;1699;1708;13102;34945;54363595;53458946;39729270;1435806;81.0;79.7;59.2;2.1
FR;2022-05-04;1780;1900;11560;25625;54365375;53460846;39740830;1461431;81.0;79.7;59.2;2.2
FR;2022-05-05;1577;1620;11764;33579;54366952;53462466;39752594;1495010;81.0;79.7;59.2;2.2
FR;2022-05-06;2014;2137;14448;37825;54368966;53464603;39767042;1532835;81.0;79.7;59.3;2.3
FR;2022-05-07;1156;1208;6225;10257;54370122;53465811;39773267;1543092;81.0;79.7;59.3;2.3
FR;2022-05-08;250;265;1143;1615;54370372;53466076;39774410;1544707;81.0;79.7;59.3;2.3
FR;2022-05-09;1212;1183;9068;20681;54371584;53467259;39783478;1565388;81.0;79.7;59.3;2.3
FR;2022-05-10;1599;1664;12005;39066;54373183;53468923;39795483;1604454;81.0;79.7;59.3;2.4
FR;2022-05-11;1892;1945;9857;27866;54375075;53470868;39805340;1632320;81.0;79.7;59.3;2.4
FR;2022-05-12;1488;1520;10426;35725;54376563;53472388;39815766;1668045;81.0;79.7;59.3;2.5
FR;2022-05-13;1887;1874;12764;38340;54378450;53474262;39828530;1706385;81.0;79.7;59.3;2.5
FR;2022-05-14;1107;1094;5337;11210;54379557;53475356;39833867;1717595;81.0;79.7;59.4;2.6
FR;2022-05-15;258;216;1203;1538;54379815;53475572;39835070;1719133;81.0;79.7;59.4;2.6
FR;2022-05-16;1105;1045;7460;20761;54380920;53476617;39842530;1739894;81.0;79.7;59.4;2.6
FR;2022-05-17;1499;1460;10066;37640;54382419;53478077;39852596;1777534;81.0;79.7;59.4;2.6
FR;2022-05-18;1703;1729;8377;26944;54384122;53479806;39860973;1804478;81.0;79.7;59.4;2.7
FR;2022-05-19;1348;1404;9341;34565;54385470;53481210;39870314;1839043;81.0;79.7;59.4;2.7
FR;2022-05-20;1779;1815;11322;39139;54387249;53483025;39881636;1878182;81.0;79.7;59.4;2.8
FR;2022-05-21;1123;1203;4902;10174;54388372;53484228;39886538;1888356;81.0;79.7;59.4;2.8
FR;2022-05-22;215;232;938;1440;54388587;53484460;39887476;1889796;81.0;79.7;59.4;2.8
FR;2022-05-23;1030;1113;6767;19741;54389617;53485573;39894243;1909537;81.0;79.7;59.4;2.8
FR;2022-05-24;1383;1464;9495;36516;54391000;53487037;39903738;1946053;81.0;79.7;59.5;2.9
