fra;jour;n_dose1;n_complet;n_rappel;n_2_rappel;n_cum_dose1;n_cum_complet;n_cum_rappel;n_cum_2_rappel;couv_dose1;couv_complet;couv_rappel;couv_2_rappel
FR;2020-12-27;602;55;0;0;602;55;0;0;0.0;0.0;0.0;0.0
FR;2020-12-28;663;42;0;0;1265;97;0;0;0.0;0.0;0.0;0.0
FR;2020-12-29;373;19;0;0;1638;116;0;0;0.0;0.0;0.0;0.0
FR;2020-12-30;439;18;0;0;2077;134;0;0;0.0;0.0;0.0;0.0
FR;2020-12-31;415;22;0;0;2492;156;0;0;0.0;0.0;0.0;0.0
FR;2021-01-01;1135;64;0;0;3627;220;0;0;0.0;0.0;0.0;0.0
FR;2021-01-02;356;30;0;0;3983;250;0;0;0.0;0.0;0.0;0.0
FR;2021-01-03;399;27;0;0;4382;277;0;0;0.0;0.0;0.0;0.0
FR;2021-01-04;2087;48;0;0;6469;325;0;0;0.0;0.0;0.0;0.0
FR;2021-01-05;7562;122;0;0;14031;447;0;0;0.0;0.0;0.0;0.0
FR;2021-01-06;12412;119;0;0;26443;566;0;0;0.0;0.0;0.0;0.0
FR;2021-01-07;29446;158;0;0;55889;724;0;0;0.1;0.0;0.0;0.0
FR;2021-01-08;37121;195;0;0;93010;919;0;0;0.1;0.0;0.0;0.0
FR;2021-01-09;11209;76;0;0;104219;995;0;0;0.2;0.0;0.0;0.0
FR;2021-01-10;5996;24;0;0;110215;1019;0;0;0.2;0.0;0.0;0.0
FR;2021-01-11;39922;227;0;0;150137;1246;0;0;0.2;0.0;0.0;0.0
FR;2021-01-12;62119;310;0;0;212256;1556;0;0;0.3;0.0;0.0;0.0
FR;2021-01-13;65096;434;0;0;277352;1990;0;0;0.4;0.0;0.0;0.0
FR;2021-01-14;83123;1190;0;0;360475;3180;0;0;0.5;0.0;0.0;0.0
FR;2021-01-15;68987;560;0;0;429462;3740;0;0;0.6;0.0;0.0;0.0
FR;2021-01-16;20208;189;0;0;449670;3929;0;0;0.7;0.0;0.0;0.0
FR;2021-01-17;10976;131;0;0;460646;4060;0;0;0.7;0.0;0.0;0.0
FR;2021-01-18;85878;612;0;0;546524;4672;0;0;0.8;0.0;0.0;0.0
FR;2021-01-19;130571;865;0;0;677095;5537;0;0;1.0;0.0;0.0;0.0
FR;2021-01-20;137524;853;0;0;814619;6390;0;0;1.2;0.0;0.0;0.0
FR;2021-01-21;158368;968;0;0;972987;7358;0;0;1.4;0.0;0.0;0.0
FR;2021-01-22;121038;831;0;0;1094025;8189;0;0;1.6;0.0;0.0;0.0
FR;2021-01-23;38464;203;0;0;1132489;8392;0;0;1.7;0.0;0.0;0.0
FR;2021-01-24;9740;134;0;0;1142229;8526;0;0;1.7;0.0;0.0;0.0
FR;2021-01-25;78217;1629;0;0;1220446;10155;0;0;1.8;0.0;0.0;0.0
FR;2021-01-26;100359;3761;0;0;1320805;13916;0;0;2.0;0.0;0.0;0.0
FR;2021-01-27;107223;6643;0;0;1428028;20559;0;0;2.1;0.0;0.0;0.0
FR;2021-01-28;124324;15768;0;0;1552352;36327;0;0;2.3;0.1;0.0;0.0
FR;2021-01-29;92168;18259;0;0;1644520;54586;0;0;2.5;0.1;0.0;0.0
FR;2021-01-30;29110;4373;0;0;1673630;58959;0;0;2.5;0.1;0.0;0.0
FR;2021-01-31;5225;1769;0;0;1678855;60728;0;0;2.5;0.1;0.0;0.0
FR;2021-02-01;53103;21740;0;0;1731958;82468;0;0;2.6;0.1;0.0;0.0
FR;2021-02-02;72275;36104;0;0;1804233;118572;0;0;2.7;0.2;0.0;0.0
FR;2021-02-03;72284;38343;0;0;1876517;156915;0;0;2.8;0.2;0.0;0.0
FR;2021-02-04;82047;51971;0;0;1958564;208886;0;0;2.9;0.3;0.0;0.0
FR;2021-02-05;68216;46468;0;0;2026780;255354;0;0;3.0;0.4;0.0;0.0
FR;2021-02-06;23109;10962;0;0;2049889;266316;0;0;3.1;0.4;0.0;0.0
FR;2021-02-07;5182;5362;0;0;2055071;271678;0;0;3.1;0.4;0.0;0.0
FR;2021-02-08;46815;47246;0;0;2101886;318924;0;0;3.1;0.5;0.0;0.0
FR;2021-02-09;65990;75305;0;0;2167876;394229;0;0;3.2;0.6;0.0;0.0
FR;2021-02-10;70982;80326;0;0;2238858;474555;0;0;3.3;0.7;0.0;0.0
FR;2021-02-11;87237;102766;0;0;2326095;577321;0;0;3.5;0.9;0.0;0.0
FR;2021-02-12;79287;76494;0;0;2405382;653815;0;0;3.6;1.0;0.0;0.0
FR;2021-02-13;22351;19782;0;0;2427733;673597;0;0;3.6;1.0;0.0;0.0
FR;2021-02-14;5071;7297;0;0;2432804;680894;0;0;3.6;1.0;0.0;0.0
FR;2021-02-15;38068;77381;0;0;2470872;758275;0;0;3.7;1.1;0.0;0.0
FR;2021-02-16;50363;101645;0;0;2521235;859920;0;0;3.8;1.3;0.0;0.0
FR;2021-02-17;50496;105763;0;0;2571731;965683;0;0;3.8;1.4;0.0;0.0
FR;2021-02-18;69755;122102;0;0;2641486;1087785;0;0;3.9;1.6;0.0;0.0
FR;2021-02-19;65048;92688;0;0;2706534;1180473;0;0;4.0;1.8;0.0;0.0
FR;2021-02-20;18573;28846;0;0;2725107;1209319;0;0;4.1;1.8;0.0;0.0
FR;2021-02-21;3314;6404;0;0;2728421;1215723;0;0;4.1;1.8;0.0;0.0
FR;2021-02-22;37476;73950;0;0;2765897;1289673;0;0;4.1;1.9;0.0;0.0
FR;2021-02-23;53759;85768;0;0;2819656;1375441;0;0;4.2;2.0;0.0;0.0
FR;2021-02-24;59978;83083;0;0;2879634;1458524;0;0;4.3;2.2;0.0;0.0
FR;2021-02-25;100541;94245;0;0;2980175;1552769;0;0;4.4;2.3;0.0;0.0
FR;2021-02-26;113429;73737;0;0;3093604;1626506;0;0;4.6;2.4;0.0;0.0
FR;2021-02-27;52091;23351;0;0;3145695;1649857;0;0;4.7;2.5;0.0;0.0
FR;2021-02-28;6190;4480;0;0;3151885;1654337;0;0;4.7;2.5;0.0;0.0
FR;2021-03-01;65830;55068;0;0;3217715;1709405;0;0;4.8;2.5;0.0;0.0
FR;2021-03-02;101345;69497;0;0;3319060;1778902;0;0;4.9;2.7;0.0;0.0
FR;2021-03-03;116462;69095;0;0;3435522;1847997;0;0;5.1;2.8;0.0;0.0
FR;2021-03-04;163582;75635;0;0;3599104;1923632;0;0;5.4;2.9;0.0;0.0
FR;2021-03-05;200881;69764;0;0;3799985;1993396;0;0;5.7;3.0;0.0;0.0
FR;2021-03-06;207923;23028;0;0;4007908;2016424;0;0;6.0;3.0;0.0;0.0
FR;2021-03-07;121250;8304;0;0;4129158;2024728;0;0;6.2;3.0;0.0;0.0
FR;2021-03-08;107110;53785;0;0;4236268;2078513;0;0;6.3;3.1;0.0;0.0
FR;2021-03-09;172409;61888;0;0;4408677;2140401;0;0;6.6;3.2;0.0;0.0
FR;2021-03-10;178932;62709;0;0;4587609;2203110;0;0;6.8;3.3;0.0;0.0
FR;2021-03-11;242822;71464;0;0;4830431;2274574;0;0;7.2;3.4;0.0;0.0
FR;2021-03-12;294772;62814;0;0;5125203;2337388;0;0;7.6;3.5;0.0;0.0
FR;2021-03-13;231370;21301;0;0;5356573;2358689;0;0;8.0;3.5;0.0;0.0
FR;2021-03-14;63334;5336;0;0;5419907;2364025;0;0;8.1;3.5;0.0;0.0
FR;2021-03-15;158600;36797;0;0;5578507;2400822;0;0;8.3;3.6;0.0;0.0
FR;2021-03-16;141538;43229;0;0;5720045;2444051;0;0;8.5;3.6;0.0;0.0
FR;2021-03-17;150443;42928;0;0;5870488;2486979;0;0;8.7;3.7;0.0;0.0
FR;2021-03-18;167780;50020;0;0;6038268;2536999;0;0;9.0;3.8;0.0;0.0
FR;2021-03-19;229961;44516;0;0;6268229;2581515;0;0;9.3;3.8;0.0;0.0
FR;2021-03-20;166639;16220;0;0;6434868;2597735;0;0;9.6;3.9;0.0;0.0
FR;2021-03-21;49918;4279;0;0;6484786;2602014;0;0;9.7;3.9;0.0;0.0
FR;2021-03-22;169993;39456;0;0;6654779;2641470;0;0;9.9;3.9;0.0;0.0
FR;2021-03-23;250329;50170;0;0;6905108;2691640;0;0;10.3;4.0;0.0;0.0
FR;2021-03-24;256847;51731;0;0;7161955;2743371;0;0;10.7;4.1;0.0;0.0
FR;2021-03-25;341745;55797;0;0;7503700;2799168;0;0;11.2;4.2;0.0;0.0
FR;2021-03-26;358744;53555;0;0;7862444;2852723;0;0;11.7;4.3;0.0;0.0
FR;2021-03-27;195238;23141;0;0;8057682;2875864;0;0;12.0;4.3;0.0;0.0
FR;2021-03-28;59321;6058;0;0;8117003;2881922;0;0;12.1;4.3;0.0;0.0
FR;2021-03-29;202927;60704;0;0;8319930;2942626;0;0;12.4;4.4;0.0;0.0
FR;2021-03-30;285406;79977;0;0;8605336;3022603;0;0;12.8;4.5;0.0;0.0
FR;2021-03-31;262961;83815;0;0;8868297;3106418;0;0;13.2;4.6;0.0;0.0
FR;2021-04-01;315380;102655;0;0;9183677;3209073;0;0;13.7;4.8;0.0;0.0
FR;2021-04-02;281276;104473;0;0;9464953;3313546;0;0;14.1;4.9;0.0;0.0
FR;2021-04-03;141047;67128;0;0;9606000;3380674;0;0;14.3;5.0;0.0;0.0
FR;2021-04-04;46449;20775;0;0;9652449;3401449;0;0;14.4;5.1;0.0;0.0
FR;2021-04-05;63304;13453;0;0;9715753;3414902;0;0;14.5;5.1;0.0;0.0
FR;2021-04-06;217140;117880;0;0;9932893;3532782;0;0;14.8;5.3;0.0;0.0
FR;2021-04-07;260187;126588;0;0;10193080;3659370;0;0;15.2;5.5;0.0;0.0
FR;2021-04-08;337731;137181;0;0;10530811;3796551;0;0;15.7;5.7;0.0;0.0
FR;2021-04-09;410078;133590;0;0;10940889;3930141;0;0;16.3;5.9;0.0;0.0
FR;2021-04-10;212581;90948;0;0;11153470;4021089;0;0;16.6;6.0;0.0;0.0
FR;2021-04-11;56122;36945;0;0;11209592;4058034;0;0;16.7;6.0;0.0;0.0
FR;2021-04-12;236997;124718;0;0;11446589;4182752;0;0;17.1;6.2;0.0;0.0
FR;2021-04-13;309415;157374;0;0;11756004;4340126;0;0;17.5;6.5;0.0;0.0
FR;2021-04-14;294431;152558;0;0;12050435;4492684;0;0;18.0;6.7;0.0;0.0
FR;2021-04-15;337005;163744;0;0;12387440;4656428;0;0;18.5;6.9;0.0;0.0
FR;2021-04-16;339221;160440;0;0;12726661;4816868;0;0;19.0;7.2;0.0;0.0
FR;2021-04-17;188621;97660;0;0;12915282;4914528;0;0;19.2;7.3;0.0;0.0
FR;2021-04-18;51601;37780;0;0;12966883;4952308;0;0;19.3;7.4;0.0;0.0
FR;2021-04-19;205639;147258;0;0;13172522;5099566;0;0;19.6;7.6;0.0;0.0
FR;2021-04-20;254341;182356;0;0;13426863;5281922;0;0;20.0;7.9;0.0;0.0
FR;2021-04-21;253175;180990;0;0;13680038;5462912;0;0;20.4;8.1;0.0;0.0
FR;2021-04-22;287486;203202;0;0;13967524;5666114;0;0;20.8;8.4;0.0;0.0
FR;2021-04-23;297925;202427;0;0;14265449;5868541;0;0;21.3;8.7;0.0;0.0
FR;2021-04-24;190407;121948;0;0;14455856;5990489;0;0;21.5;8.9;0.0;0.0
FR;2021-04-25;69537;42490;0;0;14525393;6032979;0;0;21.6;9.0;0.0;0.0
FR;2021-04-26;220889;169368;0;0;14746282;6202347;0;0;22.0;9.2;0.0;0.0
FR;2021-04-27;284544;210552;0;0;15030826;6412899;0;0;22.4;9.6;0.0;0.0
FR;2021-04-28;299431;208231;1;0;15330257;6621130;1;0;22.8;9.9;0.0;0.0
FR;2021-04-29;357052;231498;0;0;15687309;6852628;1;0;23.4;10.2;0.0;0.0
FR;2021-04-30;372130;224062;0;0;16059439;7076690;1;0;23.9;10.5;0.0;0.0
FR;2021-05-01;167596;63727;0;0;16227035;7140417;1;0;24.2;10.6;0.0;0.0
FR;2021-05-02;91706;43453;0;0;16318741;7183870;1;0;24.3;10.7;0.0;0.0
FR;2021-05-03;288851;188928;0;0;16607592;7372798;1;0;24.7;11.0;0.0;0.0
FR;2021-05-04;315584;250469;0;0;16923176;7623267;1;0;25.2;11.4;0.0;0.0
FR;2021-05-05;327092;249690;0;0;17250268;7872957;1;0;25.7;11.7;0.0;0.0
FR;2021-05-06;379418;273573;0;0;17629686;8146530;1;0;26.3;12.1;0.0;0.0
FR;2021-05-07;372678;298241;0;0;18002364;8444771;1;0;26.8;12.6;0.0;0.0
FR;2021-05-08;222133;82503;0;0;18224497;8527274;1;0;27.2;12.7;0.0;0.0
FR;2021-05-09;129684;55039;0;0;18354181;8582313;1;0;27.3;12.8;0.0;0.0
FR;2021-05-10;313292;254390;0;0;18667473;8836703;1;0;27.8;13.2;0.0;0.0
FR;2021-05-11;403815;296170;0;0;19071288;9132873;1;0;28.4;13.6;0.0;0.0
FR;2021-05-12;434023;269211;0;0;19505311;9402084;1;0;29.1;14.0;0.0;0.0
FR;2021-05-13;338543;78407;0;0;19843854;9480491;1;0;29.6;14.1;0.0;0.0
FR;2021-05-14;454051;202761;0;0;20297905;9683252;1;0;30.2;14.4;0.0;0.0
FR;2021-05-15;374916;120382;0;0;20672821;9803634;1;0;30.8;14.6;0.0;0.0
FR;2021-05-16;202717;34173;0;0;20875538;9837807;1;0;31.1;14.7;0.0;0.0
FR;2021-05-17;376055;178565;0;0;21251593;10016372;1;0;31.7;14.9;0.0;0.0
FR;2021-05-18;460054;192197;0;0;21711647;10208569;1;0;32.3;15.2;0.0;0.0
FR;2021-05-19;467317;182007;0;0;22178964;10390576;1;0;33.0;15.5;0.0;0.0
FR;2021-05-20;507454;204132;0;0;22686418;10594708;1;0;33.8;15.8;0.0;0.0
FR;2021-05-21;489567;220833;0;0;23175985;10815541;1;0;34.5;16.1;0.0;0.0
FR;2021-05-22;347137;108271;0;0;23523122;10923812;1;0;35.0;16.3;0.0;0.0
FR;2021-05-23;161636;26873;0;0;23684758;10950685;1;0;35.3;16.3;0.0;0.0
FR;2021-05-24;263130;53017;0;0;23947888;11003702;1;0;35.7;16.4;0.0;0.0
FR;2021-05-25;400141;225625;0;0;24348029;11229327;1;0;36.3;16.7;0.0;0.0
FR;2021-05-26;413357;226437;0;0;24761386;11455764;1;0;36.9;17.1;0.0;0.0
FR;2021-05-27;449695;265633;0;0;25211081;11721397;1;0;37.6;17.5;0.0;0.0
FR;2021-05-28;429442;317396;0;0;25640523;12038793;1;0;38.2;17.9;0.0;0.0
FR;2021-05-29;298940;182135;0;0;25939463;12220928;1;0;38.6;18.2;0.0;0.0
FR;2021-05-30;107096;42161;0;0;26046559;12263089;1;0;38.8;18.3;0.0;0.0
FR;2021-05-31;357917;241599;1;0;26404476;12504688;2;0;39.3;18.6;0.0;0.0
FR;2021-06-01;430832;302799;1;0;26835308;12807487;3;0;40.0;19.1;0.0;0.0
FR;2021-06-02;419295;278103;0;0;27254603;13085590;3;0;40.6;19.5;0.0;0.0
FR;2021-06-03;464588;313039;0;0;27719191;13398629;3;0;41.3;20.0;0.0;0.0
FR;2021-06-04;455686;361985;1;0;28174877;13760614;4;0;42.0;20.5;0.0;0.0
FR;2021-06-05;304745;222126;0;0;28479622;13982740;4;0;42.4;20.8;0.0;0.0
FR;2021-06-06;133236;61273;0;0;28612858;14044013;4;0;42.6;20.9;0.0;0.0
FR;2021-06-07;338974;298985;0;0;28951832;14342998;4;0;43.1;21.4;0.0;0.0
FR;2021-06-08;393558;337753;0;0;29345390;14680751;4;0;43.7;21.9;0.0;0.0
FR;2021-06-09;384660;319847;0;0;29730050;15000598;4;0;44.3;22.4;0.0;0.0
FR;2021-06-10;403955;338316;0;0;30134005;15338914;4;0;44.9;22.9;0.0;0.0
FR;2021-06-11;386463;407549;0;0;30520468;15746463;4;0;45.5;23.5;0.0;0.0
FR;2021-06-12;283203;243391;0;0;30803671;15989854;4;0;45.9;23.8;0.0;0.0
FR;2021-06-13;104828;84981;0;0;30908499;16074835;4;0;46.1;24.0;0.0;0.0
FR;2021-06-14;240646;384639;0;0;31149145;16459474;4;0;46.4;24.5;0.0;0.0
FR;2021-06-15;307977;424319;0;0;31457122;16883793;4;0;46.9;25.2;0.0;0.0
FR;2021-06-16;313836;395476;0;0;31770958;17279269;4;0;47.3;25.7;0.0;0.0
FR;2021-06-17;317553;413565;0;0;32088511;17692834;4;0;47.8;26.4;0.0;0.0
FR;2021-06-18;321551;485759;0;0;32410062;18178593;4;0;48.3;27.1;0.0;0.0
FR;2021-06-19;224305;300943;0;0;32634367;18479536;4;0;48.6;27.5;0.0;0.0
FR;2021-06-20;74364;111784;0;0;32708731;18591320;4;0;48.7;27.7;0.0;0.0
FR;2021-06-21;195565;427747;1;0;32904296;19019067;5;0;49.0;28.3;0.0;0.0
FR;2021-06-22;223000;499962;2;0;33127296;19519029;7;0;49.4;29.1;0.0;0.0
FR;2021-06-23;233865;474039;1;0;33361161;19993068;8;0;49.7;29.8;0.0;0.0
FR;2021-06-24;241725;447074;0;0;33602886;20440142;8;0;50.1;30.5;0.0;0.0
FR;2021-06-25;227463;561195;0;0;33830349;21001337;8;0;50.4;31.3;0.0;0.0
FR;2021-06-26;153191;395469;0;0;33983540;21396806;8;0;50.6;31.9;0.0;0.0
FR;2021-06-27;55861;165126;0;0;34039401;21561932;8;0;50.7;32.1;0.0;0.0
FR;2021-06-28;154611;478397;0;0;34194012;22040329;8;0;50.9;32.8;0.0;0.0
FR;2021-06-29;182539;538276;0;0;34376551;22578605;8;0;51.2;33.6;0.0;0.0
FR;2021-06-30;203834;516790;2;0;34580385;23095395;10;0;51.5;34.4;0.0;0.0
FR;2021-07-01;231102;497926;1;0;34811487;23593321;11;0;51.9;35.2;0.0;0.0
FR;2021-07-02;228305;562680;3;0;35039792;24156001;14;0;52.2;36.0;0.0;0.0
FR;2021-07-03;141930;395318;1;0;35181722;24551319;15;0;52.4;36.6;0.0;0.0
FR;2021-07-04;56691;150977;0;0;35238413;24702296;15;0;52.5;36.8;0.0;0.0
FR;2021-07-05;168207;449381;2;0;35406620;25151677;17;0;52.8;37.5;0.0;0.0
FR;2021-07-06;196547;511527;8;0;35603167;25663204;25;0;53.0;38.2;0.0;0.0
FR;2021-07-07;212922;477923;5;0;35816089;26141127;30;0;53.4;38.9;0.0;0.0
FR;2021-07-08;231437;468298;7;0;36047526;26609425;37;0;53.7;39.6;0.0;0.0
FR;2021-07-09;228338;557182;2;0;36275864;27166607;39;0;54.1;40.5;0.0;0.0
FR;2021-07-10;148532;368903;1;0;36424396;27535510;40;0;54.3;41.0;0.0;0.0
FR;2021-07-11;60140;121098;0;0;36484536;27656608;40;0;54.4;41.2;0.0;0.0
FR;2021-07-12;168954;513162;0;0;36653490;28169770;40;0;54.6;42.0;0.0;0.0
FR;2021-07-13;287058;586711;2;0;36940548;28756481;42;0;55.0;42.8;0.0;0.0
FR;2021-07-14;180881;187150;0;0;37121429;28943631;42;0;55.3;43.1;0.0;0.0
FR;2021-07-15;346862;572756;0;0;37468291;29516387;42;0;55.8;44.0;0.0;0.0
FR;2021-07-16;379901;575420;1;0;37848192;30091807;43;0;56.4;44.8;0.0;0.0
FR;2021-07-17;259648;368945;0;0;38107840;30460752;43;0;56.8;45.4;0.0;0.0
FR;2021-07-18;109663;133307;0;0;38217503;30594059;43;0;56.9;45.6;0.0;0.0
FR;2021-07-19;285310;480259;0;0;38502813;31074318;43;0;57.4;46.3;0.0;0.0
FR;2021-07-20;376719;524977;0;0;38879532;31599295;43;0;57.9;47.1;0.0;0.0
FR;2021-07-21;395624;483133;2;0;39275156;32082428;45;0;58.5;47.8;0.0;0.0
FR;2021-07-22;440875;472832;2;0;39716031;32555260;47;0;59.2;48.5;0.0;0.0
FR;2021-07-23;439833;511383;2;0;40155864;33066643;49;0;59.8;49.3;0.0;0.0
FR;2021-07-24;285178;322365;0;0;40441042;33389008;49;0;60.3;49.7;0.0;0.0
FR;2021-07-25;121050;100467;0;0;40562092;33489475;49;0;60.4;49.9;0.0;0.0
FR;2021-07-26;347262;385971;2;0;40909354;33875446;51;0;61.0;50.5;0.0;0.0
FR;2021-07-27;463880;401683;2;0;41373234;34277129;53;0;61.6;51.1;0.0;0.0
FR;2021-07-28;459290;367900;2;0;41832524;34645029;55;0;62.3;51.6;0.0;0.0
FR;2021-07-29;489677;358077;1;0;42322201;35003106;56;0;63.1;52.2;0.0;0.0
FR;2021-07-30;461626;381659;2;0;42783827;35384765;58;0;63.7;52.7;0.0;0.0
FR;2021-07-31;285337;231703;0;0;43069164;35616468;58;0;64.2;53.1;0.0;0.0
FR;2021-08-01;111935;65829;0;0;43181099;35682297;58;0;64.3;53.2;0.0;0.0
FR;2021-08-02;341206;285570;0;0;43522305;35967867;58;0;64.8;53.6;0.0;0.0
FR;2021-08-03;398396;305465;1;0;43920701;36273332;59;0;65.4;54.0;0.0;0.0
FR;2021-08-04;384622;266512;3;0;44305323;36539844;62;0;66.0;54.4;0.0;0.0
FR;2021-08-05;365973;282633;0;0;44671296;36822477;62;0;66.6;54.9;0.0;0.0
FR;2021-08-06;359546;327402;1;0;45030842;37149879;63;0;67.1;55.4;0.0;0.0
FR;2021-08-07;213035;210268;3;0;45243877;37360147;66;0;67.4;55.7;0.0;0.0
FR;2021-08-08;74130;73745;0;0;45318007;37433892;66;0;67.5;55.8;0.0;0.0
FR;2021-08-09;258570;298679;3;0;45576577;37732571;69;0;67.9;56.2;0.0;0.0
FR;2021-08-10;306595;324707;1;0;45883172;38057278;70;0;68.4;56.7;0.0;0.0
FR;2021-08-11;279517;302638;1;0;46162689;38359916;71;0;68.8;57.2;0.0;0.0
FR;2021-08-12;271366;321202;1;0;46434055;38681118;72;0;69.2;57.6;0.0;0.0
FR;2021-08-13;252029;317031;2;0;46686084;38998149;74;0;69.6;58.1;0.0;0.0
FR;2021-08-14;145275;219426;0;0;46831359;39217575;74;0;69.8;58.4;0.0;0.0
FR;2021-08-15;39299;55726;0;0;46870658;39273301;74;0;69.8;58.5;0.0;0.0
FR;2021-08-16;186039;346343;0;0;47056697;39619644;74;0;70.1;59.0;0.0;0.0
FR;2021-08-17;215552;369932;1;0;47272249;39989576;75;0;70.4;59.6;0.0;0.0
FR;2021-08-18;198921;355271;4;0;47471170;40344847;79;0;70.7;60.1;0.0;0.0
FR;2021-08-19;191879;356636;0;0;47663049;40701483;79;0;71.0;60.6;0.0;0.0
FR;2021-08-20;186341;397175;2;0;47849390;41098658;81;0;71.3;61.2;0.0;0.0
FR;2021-08-21;104750;254746;0;0;47954140;41353404;81;0;71.5;61.6;0.0;0.0
FR;2021-08-22;31885;92211;1;0;47986025;41445615;82;0;71.5;61.8;0.0;0.0
FR;2021-08-23;140884;380220;2;0;48126909;41825835;84;0;71.7;62.3;0.0;0.0
FR;2021-08-24;162402;403583;1;0;48289311;42229418;85;0;72.0;62.9;0.0;0.0
FR;2021-08-25;151057;376054;3;0;48440368;42605472;88;0;72.2;63.5;0.0;0.0
FR;2021-08-26;142733;368358;1;0;48583101;42973830;89;0;72.4;64.0;0.0;0.0
FR;2021-08-27;148360;415548;3;0;48731461;43389378;92;0;72.6;64.6;0.0;0.0
FR;2021-08-28;90603;265280;0;0;48822064;43654658;92;0;72.7;65.0;0.0;0.0
FR;2021-08-29;27305;88398;0;0;48849369;43743056;92;0;72.8;65.2;0.0;0.0
FR;2021-08-30;117320;342662;6026;1;48966689;44085718;6118;1;73.0;65.7;0.0;0.0
FR;2021-08-31;128713;354210;11880;2;49095402;44439928;17998;3;73.2;66.2;0.0;0.0
FR;2021-09-01;135739;302702;24310;3;49231141;44742630;42308;6;73.4;66.7;0.1;0.0
FR;2021-09-02;112583;262491;28856;1;49343724;45005121;71164;7;73.5;67.1;0.1;0.0
FR;2021-09-03;118185;309707;32959;6;49461909;45314828;104123;13;73.7;67.5;0.2;0.0
FR;2021-09-04;89795;230673;14071;5;49551704;45545501;118194;18;73.8;67.9;0.2;0.0
FR;2021-09-05;21334;48361;4731;0;49573038;45593862;122925;18;73.9;67.9;0.2;0.0
FR;2021-09-06;75318;191203;34248;2;49648356;45785065;157173;20;74.0;68.2;0.2;0.0
FR;2021-09-07;80064;191505;36092;3;49728420;45976570;193265;23;74.1;68.5;0.3;0.0
FR;2021-09-08;89691;216950;32454;6;49818111;46193520;225719;29;74.2;68.8;0.3;0.0
FR;2021-09-09;76649;174518;36522;16;49894760;46368038;262241;45;74.3;69.1;0.4;0.0
FR;2021-09-10;95590;215256;40516;13;49990350;46583294;302757;58;74.5;69.4;0.5;0.0
FR;2021-09-11;66729;178307;14308;1;50057079;46761601;317065;59;74.6;69.7;0.5;0.0
FR;2021-09-12;12792;34159;3160;2;50069871;46795760;320225;61;74.6;69.7;0.5;0.0
FR;2021-09-13;64366;134685;44041;29;50134237;46930445;364266;90;74.7;69.9;0.5;0.0
FR;2021-09-14;73303;136310;62018;52;50207540;47066755;426284;142;74.8;70.1;0.6;0.0
FR;2021-09-15;76404;174881;54773;99;50283944;47241636;481057;241;74.9;70.4;0.7;0.0
FR;2021-09-16;63754;117981;60015;126;50347698;47359617;541072;367;75.0;70.6;0.8;0.0
FR;2021-09-17;74961;159834;57224;93;50422659;47519451;598296;460;75.1;70.8;0.9;0.0
FR;2021-09-18;48185;144337;17280;24;50470844;47663788;615576;484;75.2;71.0;0.9;0.0
FR;2021-09-19;7866;24928;2621;3;50478710;47688716;618197;487;75.2;71.1;0.9;0.0
FR;2021-09-20;44441;96446;50250;56;50523151;47785162;668447;543;75.3;71.2;1.0;0.0
FR;2021-09-21;45804;98510;63363;128;50568955;47883672;731810;671;75.3;71.3;1.1;0.0
FR;2021-09-22;48583;144827;55344;67;50617538;48028499;787154;738;75.4;71.6;1.2;0.0
FR;2021-09-23;43157;91248;63466;123;50660695;48119747;850620;861;75.5;71.7;1.3;0.0
FR;2021-09-24;52199;132456;59088;104;50712894;48252203;909708;965;75.6;71.9;1.4;0.0
FR;2021-09-25;35191;118556;18253;27;50748085;48370759;927961;992;75.6;72.1;1.4;0.0
FR;2021-09-26;5524;18691;2329;5;50753609;48389450;930290;997;75.6;72.1;1.4;0.0
FR;2021-09-27;33919;78890;48123;113;50787528;48468340;978413;1110;75.7;72.2;1.5;0.0
FR;2021-09-28;36444;74414;56457;84;50823972;48542754;1034870;1194;75.7;72.3;1.5;0.0
FR;2021-09-29;44311;103042;54804;78;50868283;48645796;1089674;1272;75.8;72.5;1.6;0.0
FR;2021-09-30;36267;71386;59468;89;50904550;48717182;1149142;1361;75.8;72.6;1.7;0.0
FR;2021-10-01;61515;99688;63677;54;50966065;48816870;1212819;1415;75.9;72.7;1.8;0.0
FR;2021-10-02;39412;81684;23316;18;51005477;48898554;1236135;1433;76.0;72.9;1.8;0.0
FR;2021-10-03;5261;11290;2539;4;51010738;48909844;1238674;1437;76.0;72.9;1.8;0.0
FR;2021-10-04;34945;59562;54775;82;51045683;48969406;1293449;1519;76.1;73.0;1.9;0.0
FR;2021-10-05;33548;62205;64914;74;51079231;49031611;1358363;1593;76.1;73.1;2.0;0.0
FR;2021-10-06;42412;80218;68208;43;51121643;49111829;1426571;1636;76.2;73.2;2.1;0.0
FR;2021-10-07;30390;59471;68658;87;51152033;49171300;1495229;1723;76.2;73.3;2.2;0.0
FR;2021-10-08;48738;89888;84609;71;51200771;49261188;1579838;1794;76.3;73.4;2.4;0.0
FR;2021-10-09;33621;64130;33852;20;51234392;49325318;1613690;1814;76.3;73.5;2.4;0.0
FR;2021-10-10;4586;7928;3483;2;51238978;49333246;1617173;1816;76.3;73.5;2.4;0.0
FR;2021-10-11;30554;50661;64022;94;51269532;49383907;1681195;1910;76.4;73.6;2.5;0.0
FR;2021-10-12;31335;51434;75826;59;51300867;49435341;1757021;1969;76.4;73.7;2.6;0.0
FR;2021-10-13;39977;62842;79248;51;51340844;49498183;1836269;2020;76.5;73.8;2.7;0.0
FR;2021-10-14;30222;49746;73751;49;51371066;49547929;1910020;2069;76.5;73.8;2.8;0.0
FR;2021-10-15;44732;70450;102882;60;51415798;49618379;2012902;2129;76.6;73.9;3.0;0.0
FR;2021-10-16;31269;46729;39608;24;51447067;49665108;2052510;2153;76.7;74.0;3.1;0.0
FR;2021-10-17;3826;5693;3692;3;51450893;49670801;2056202;2156;76.7;74.0;3.1;0.0
FR;2021-10-18;28285;42669;71328;37;51479178;49713470;2127530;2193;76.7;74.1;3.2;0.0
FR;2021-10-19;27047;42147;81602;71;51506225;49755617;2209132;2264;76.7;74.1;3.3;0.0
FR;2021-10-20;35199;51888;101456;93;51541424;49807505;2310588;2357;76.8;74.2;3.4;0.0
FR;2021-10-21;25921;42010;89099;45;51567345;49849515;2399687;2402;76.8;74.3;3.6;0.0
FR;2021-10-22;38186;59334;112474;91;51605531;49908849;2512161;2493;76.9;74.4;3.7;0.0
FR;2021-10-23;26963;42457;48594;24;51632494;49951306;2560755;2517;76.9;74.4;3.8;0.0
FR;2021-10-24;2912;5021;3936;3;51635406;49956327;2564691;2520;76.9;74.4;3.8;0.0
FR;2021-10-25;25973;35639;86594;67;51661379;49991966;2651285;2587;77.0;74.5;4.0;0.0
FR;2021-10-26;23680;32299;92311;48;51685059;50024265;2743596;2635;77.0;74.5;4.1;0.0
FR;2021-10-27;30006;44205;114605;73;51715065;50068470;2858201;2708;77.1;74.6;4.3;0.0
FR;2021-10-28;23380;31212;94363;62;51738445;50099682;2952564;2770;77.1;74.6;4.4;0.0
FR;2021-10-29;31500;46504;125238;80;51769945;50146186;3077802;2850;77.1;74.7;4.6;0.0
FR;2021-10-30;20521;32841;53354;27;51790466;50179027;3131156;2877;77.2;74.8;4.7;0.0
FR;2021-10-31;2477;3875;3867;3;51792943;50182902;3135023;2880;77.2;74.8;4.7;0.0
FR;2021-11-01;8193;4960;3553;10;51801136;50187862;3138576;2890;77.2;74.8;4.7;0.0
FR;2021-11-02;25273;36343;99461;64;51826409;50224205;3238037;2954;77.2;74.8;4.8;0.0
FR;2021-11-03;29754;43603;125774;97;51856163;50267808;3363811;3051;77.3;74.9;5.0;0.0
FR;2021-11-04;23661;31638;114317;68;51879824;50299446;3478128;3119;77.3;74.9;5.2;0.0
FR;2021-11-05;32266;44711;151251;84;51912090;50344157;3629379;3203;77.3;75.0;5.4;0.0
FR;2021-11-06;21478;32462;68222;40;51933568;50376619;3697601;3243;77.4;75.1;5.5;0.0
FR;2021-11-07;2377;4059;5582;8;51935945;50380678;3703183;3251;77.4;75.1;5.5;0.0
FR;2021-11-08;20394;31074;134151;73;51956339;50411752;3837334;3324;77.4;75.1;5.7;0.0
FR;2021-11-09;22123;33106;172100;107;51978462;50444858;4009434;3431;77.4;75.2;6.0;0.0
FR;2021-11-10;31362;44237;198667;128;52009824;50489095;4208101;3559;77.5;75.2;6.3;0.0
FR;2021-11-11;4296;5859;13921;20;52014120;50494954;4222022;3579;77.5;75.2;6.3;0.0
FR;2021-11-12;28986;41886;197252;127;52043106;50536840;4419274;3706;77.5;75.3;6.6;0.0
FR;2021-11-13;20292;28353;86290;60;52063398;50565193;4505564;3766;77.6;75.3;6.7;0.0
FR;2021-11-14;2325;3405;7878;10;52065723;50568598;4513442;3776;77.6;75.3;6.7;0.0
FR;2021-11-15;20288;28082;171439;103;52086011;50596680;4684881;3879;77.6;75.4;7.0;0.0
FR;2021-11-16;23335;28006;214862;152;52109346;50624686;4899743;4031;77.6;75.4;7.3;0.0
FR;2021-11-17;30348;36729;212782;132;52139694;50661415;5112525;4163;77.7;75.5;7.6;0.0
FR;2021-11-18;23345;28815;205393;123;52163039;50690230;5317918;4286;77.7;75.5;7.9;0.0
FR;2021-11-19;33553;40092;262058;186;52196592;50730322;5579976;4472;77.8;75.6;8.3;0.0
FR;2021-11-20;25319;29398;109658;63;52221911;50759720;5689634;4535;77.8;75.6;8.5;0.0
FR;2021-11-21;2622;3483;10644;17;52224533;50763203;5700278;4552;77.8;75.6;8.5;0.0
FR;2021-11-22;22737;19170;194735;85;52247270;50782373;5895013;4637;77.8;75.7;8.8;0.0
FR;2021-11-23;25561;24460;247723;82;52272831;50806833;6142736;4719;77.9;75.7;9.2;0.0
FR;2021-11-24;31760;34771;243109;80;52304591;50841604;6385845;4799;77.9;75.8;9.5;0.0
FR;2021-11-25;25382;25191;277569;110;52329973;50866795;6663414;4909;78.0;75.8;9.9;0.0
FR;2021-11-26;33201;37583;414500;160;52363174;50904378;7077914;5069;78.0;75.8;10.5;0.0
FR;2021-11-27;23294;28645;236554;148;52386468;50933023;7314468;5217;78.1;75.9;10.9;0.0
FR;2021-11-28;3479;4128;63325;41;52389947;50937151;7377793;5258;78.1;75.9;11.0;0.0
FR;2021-11-29;19384;23452;371539;175;52409331;50960603;7749332;5433;78.1;75.9;11.5;0.0
FR;2021-11-30;24696;27265;500628;281;52434027;50987868;8249960;5714;78.1;76.0;12.3;0.0
FR;2021-12-01;26839;31865;511170;300;52460866;51019733;8761130;6014;78.2;76.0;13.1;0.0
FR;2021-12-02;21970;21379;574688;302;52482836;51041112;9335818;6316;78.2;76.1;13.9;0.0
FR;2021-12-03;25473;34152;650963;325;52508309;51075264;9986781;6641;78.2;76.1;14.9;0.0
FR;2021-12-04;18286;25916;369684;216;52526595;51101180;10356465;6857;78.3;76.1;15.4;0.0
FR;2021-12-05;4141;4962;107050;94;52530736;51106142;10463515;6951;78.3;76.1;15.6;0.0
FR;2021-12-06;22692;25744;539816;383;52553428;51131886;11003331;7334;78.3;76.2;16.4;0.0
FR;2021-12-07;23310;29180;706137;407;52576738;51161066;11709468;7741;78.3;76.2;17.4;0.0
FR;2021-12-08;25331;35429;647316;436;52602069;51196495;12356784;8177;78.4;76.3;18.4;0.0
FR;2021-12-09;23991;29489;726168;454;52626060;51225984;13082952;8631;78.4;76.3;19.5;0.0
FR;2021-12-10;27655;38316;805971;461;52653715;51264300;13888923;9092;78.5;76.4;20.7;0.0
FR;2021-12-11;20220;29942;480319;353;52673935;51294242;14369242;9445;78.5;76.4;21.4;0.0
FR;2021-12-12;5624;6466;159226;107;52679559;51300708;14528468;9552;78.5;76.4;21.6;0.0
FR;2021-12-13;21059;30175;649187;393;52700618;51330883;15177655;9945;78.5;76.5;22.6;0.0
FR;2021-12-14;27565;35839;847347;681;52728183;51366722;16025002;10626;78.6;76.5;23.9;0.0
FR;2021-12-15;28192;39910;768908;490;52756375;51406632;16793910;11116;78.6;76.6;25.0;0.0
FR;2021-12-16;27933;35611;844261;504;52784308;51442243;17638171;11620;78.6;76.6;26.3;0.0
FR;2021-12-17;31542;43768;891979;592;52815850;51486011;18530150;12212;78.7;76.7;27.6;0.0
FR;2021-12-18;24912;30238;522141;365;52840762;51516249;19052291;12577;78.7;76.8;28.4;0.0
FR;2021-12-19;8740;7969;191142;140;52849502;51524218;19243433;12717;78.7;76.8;28.7;0.0
FR;2021-12-20;31584;34242;658585;488;52881086;51558460;19902018;13205;78.8;76.8;29.7;0.0
FR;2021-12-21;39213;39230;759452;578;52920299;51597690;20661470;13783;78.9;76.9;30.8;0.0
FR;2021-12-22;39457;37475;642030;702;52959756;51635165;21303500;14485;78.9;76.9;31.7;0.0
FR;2021-12-23;33739;30378;494317;592;52993495;51665543;21797817;15077;79.0;77.0;32.5;0.0
FR;2021-12-24;10663;11606;126632;240;53004158;51677149;21924449;15317;79.0;77.0;32.7;0.0
FR;2021-12-25;767;1938;9026;72;53004925;51679087;21933475;15389;79.0;77.0;32.7;0.0
FR;2021-12-26;4696;4764;60131;169;53009621;51683851;21993606;15558;79.0;77.0;32.8;0.0
FR;2021-12-27;30362;33162;509084;673;53039983;51717013;22502690;16231;79.0;77.1;33.5;0.0
FR;2021-12-28;38306;35307;632153;1556;53078289;51752320;23134843;17787;79.1;77.1;34.5;0.0
FR;2021-12-29;39841;33276;560915;1752;53118130;51785596;23695758;19539;79.1;77.2;35.3;0.0
FR;2021-12-30;35884;29416;471090;1881;53154014;51815012;24166848;21420;79.2;77.2;36.0;0.0
FR;2021-12-31;12033;11339;131620;755;53166047;51826351;24298468;22175;79.2;77.2;36.2;0.0
FR;2022-01-01;1324;1764;9928;100;53167371;51828115;24308396;22275;79.2;77.2;36.2;0.0
FR;2022-01-02;6074;5083;66929;408;53173445;51833198;24375325;22683;79.2;77.2;36.3;0.0
FR;2022-01-03;32601;36577;551477;2642;53206046;51869775;24926802;25325;79.3;77.3;37.1;0.0
FR;2022-01-04;40877;40498;714200;3839;53246923;51910273;25641002;29164;79.3;77.3;38.2;0.0
FR;2022-01-05;60309;43378;634058;3436;53307232;51953651;26275060;32600;79.4;77.4;39.1;0.0
FR;2022-01-06;43924;40050;711312;4563;53351156;51993701;26986372;37163;79.5;77.5;40.2;0.1
FR;2022-01-07;50544;46580;790321;5004;53401700;52040281;27776693;42167;79.6;77.5;41.4;0.1
FR;2022-01-08;44950;35011;472841;2443;53446650;52075292;28249534;44610;79.6;77.6;42.1;0.1
FR;2022-01-09;15596;11489;145698;830;53462246;52086781;28395232;45440;79.7;77.6;42.3;0.1
FR;2022-01-10;34991;38403;522155;3719;53497237;52125184;28917387;49159;79.7;77.7;43.1;0.1
FR;2022-01-11;41640;42023;608385;5215;53538877;52167207;29525772;54374;79.8;77.7;44.0;0.1
FR;2022-01-12;60143;49203;504230;4492;53599020;52216410;30030002;58866;79.9;77.8;44.7;0.1
FR;2022-01-13;37897;40277;540932;5461;53636917;52256687;30570934;64327;79.9;77.9;45.6;0.1
FR;2022-01-14;42384;43339;628952;6459;53679301;52300026;31199886;70786;80.0;77.9;46.5;0.1
FR;2022-01-15;39303;31264;377536;3292;53718604;52331290;31577422;74078;80.0;78.0;47.0;0.1
FR;2022-01-16;11381;9010;99443;760;53729985;52340300;31676865;74838;80.1;78.0;47.2;0.1
FR;2022-01-17;24597;28017;354130;3961;53754582;52368317;32030995;78799;80.1;78.0;47.7;0.1
FR;2022-01-18;28101;31738;397499;5774;53782683;52400055;32428494;84573;80.1;78.1;48.3;0.1
FR;2022-01-19;43036;40263;311043;4385;53825719;52440318;32739537;88958;80.2;78.1;48.8;0.1
FR;2022-01-20;23405;29319;328416;5627;53849124;52469637;33067953;94585;80.2;78.2;49.3;0.1
FR;2022-01-21;27986;32960;401118;6582;53877110;52502597;33469071;101167;80.3;78.2;49.9;0.2
FR;2022-01-22;27607;27161;241743;2842;53904717;52529758;33710814;104009;80.3;78.3;50.2;0.2
FR;2022-01-23;6701;7509;55180;589;53911418;52537267;33765994;104598;80.3;78.3;50.3;0.2
FR;2022-01-24;16193;25046;239313;4095;53927611;52562313;34005307;108693;80.4;78.3;50.7;0.2
FR;2022-01-25;18900;28560;267027;6066;53946511;52590873;34272334;114759;80.4;78.4;51.1;0.2
FR;2022-01-26;28104;41026;229340;4474;53974615;52631899;34501674;119233;80.4;78.4;51.4;0.2
FR;2022-01-27;16270;25680;225805;5692;53990885;52657579;34727479;124925;80.4;78.5;51.7;0.2
FR;2022-01-28;21497;41813;321452;7409;54012382;52699392;35048931;132334;80.5;78.5;52.2;0.2
FR;2022-01-29;18401;32671;204568;3249;54030783;52732063;35253499;135583;80.5;78.6;52.5;0.2
FR;2022-01-30;4466;9154;45090;639;54035249;52741217;35298589;136222;80.5;78.6;52.6;0.2
FR;2022-01-31;11219;25956;164782;4243;54046468;52767173;35463371;140465;80.5;78.6;52.8;0.2
FR;2022-02-01;12805;27094;191356;7099;54059273;52794267;35654727;147564;80.5;78.7;53.1;0.2
FR;2022-02-02;19990;45642;190120;5992;54079263;52839909;35844847;153556;80.6;78.7;53.4;0.2
FR;2022-02-03;10952;24614;173291;6968;54090215;52864523;36018138;160524;80.6;78.8;53.7;0.2
FR;2022-02-04;14478;35931;264164;9206;54104693;52900454;36282302;169730;80.6;78.8;54.1;0.3
FR;2022-02-05;12781;31921;172332;3816;54117474;52932375;36454634;173546;80.6;78.9;54.3;0.3
FR;2022-02-06;2705;7327;33826;663;54120179;52939702;36488460;174209;80.6;78.9;54.4;0.3
FR;2022-02-07;9304;24412;176309;5290;54129483;52964114;36664769;179499;80.7;78.9;54.6;0.3
FR;2022-02-08;9588;20520;184321;7049;54139071;52984634;36849090;186548;80.7;78.9;54.9;0.3
FR;2022-02-09;14152;34934;192953;5778;54153223;53019568;37042043;192326;80.7;79.0;55.2;0.3
FR;2022-02-10;8262;17854;166568;6496;54161485;53037422;37208611;198822;80.7;79.0;55.4;0.3
FR;2022-02-11;10742;25598;243000;8324;54172227;53063020;37451611;207146;80.7;79.1;55.8;0.3
FR;2022-02-12;8345;22547;151703;3502;54180572;53085567;37603314;210648;80.7;79.1;56.0;0.3
FR;2022-02-13;1894;4389;30903;540;54182466;53089956;37634217;211188;80.7;79.1;56.1;0.3
FR;2022-02-14;6892;14503;166303;4774;54189358;53104459;37800520;215962;80.7;79.1;56.3;0.3
FR;2022-02-15;6850;15235;162431;6846;54196208;53119694;37962951;222808;80.8;79.1;56.6;0.3
FR;2022-02-16;9285;25594;146644;5720;54205493;53145288;38109595;228528;80.8;79.2;56.8;0.3
FR;2022-02-17;5366;12549;94753;5403;54210859;53157837;38204348;233931;80.8;79.2;56.9;0.3
FR;2022-02-18;6875;18414;129236;7399;54217734;53176251;38333584;241330;80.8;79.2;57.1;0.4
FR;2022-02-19;5340;15801;77300;3016;54223074;53192052;38410884;244346;80.8;79.3;57.2;0.4
FR;2022-02-20;1135;2882;13924;459;54224209;53194934;38424808;244805;80.8;79.3;57.3;0.4
FR;2022-02-21;4020;10036;67134;4058;54228229;53204970;38491942;248863;80.8;79.3;57.4;0.4
FR;2022-02-22;4366;11094;64406;5249;54232595;53216064;38556348;254112;80.8;79.3;57.4;0.4
FR;2022-02-23;6508;19382;71852;4590;54239103;53235446;38628200;258702;80.8;79.3;57.6;0.4
FR;2022-02-24;3744;9117;53177;4530;54242847;53244563;38681377;263232;80.8;79.3;57.6;0.4
FR;2022-02-25;5195;14520;79994;7327;54248042;53259083;38761371;270559;80.8;79.4;57.8;0.4
FR;2022-02-26;3970;12036;51452;3083;54252012;53271119;38812823;273642;80.8;79.4;57.8;0.4
FR;2022-02-27;868;1955;8932;529;54252880;53273074;38821755;274171;80.8;79.4;57.8;0.4
FR;2022-02-28;3066;7188;42870;3848;54255946;53280262;38864625;278019;80.8;79.4;57.9;0.4
FR;2022-03-01;3122;7271;44762;5509;54259068;53287533;38909387;283528;80.8;79.4;58.0;0.4
FR;2022-03-02;5072;12503;48986;4921;54264140;53300036;38958373;288449;80.9;79.4;58.0;0.4
FR;2022-03-03;2646;5786;29918;4043;54266786;53305822;38988291;292492;80.9;79.4;58.1;0.4
FR;2022-03-04;3175;8174;39384;6208;54269961;53313996;39027675;298700;80.9;79.4;58.2;0.4
FR;2022-03-05;2918;7058;25073;3130;54272879;53321054;39052748;301830;80.9;79.4;58.2;0.4
FR;2022-03-06;509;1009;3429;378;54273388;53322063;39056177;302208;80.9;79.4;58.2;0.5
FR;2022-03-07;1936;3693;17649;3298;54275324;53325756;39073826;305506;80.9;79.5;58.2;0.5
FR;2022-03-08;1966;4146;17857;4089;54277290;53329902;39091683;309595;80.9;79.5;58.2;0.5
FR;2022-03-09;3446;8503;21222;4029;54280736;53338405;39112905;313624;80.9;79.5;58.3;0.5
FR;2022-03-10;1709;3763;15675;3394;54282445;53342168;39128580;317018;80.9;79.5;58.3;0.5
FR;2022-03-11;2341;5169;22221;5468;54284786;53347337;39150801;322486;80.9;79.5;58.3;0.5
FR;2022-03-12;2655;5424;16497;3132;54287441;53352761;39167298;325618;80.9;79.5;58.4;0.5
FR;2022-03-13;385;587;2253;529;54287826;53353348;39169551;326147;80.9;79.5;58.4;0.5
FR;2022-03-14;1458;2662;13784;7280;54289284;53356010;39183335;333427;80.9;79.5;58.4;0.5
FR;2022-03-15;1592;2996;14330;11012;54290876;53359006;39197665;344439;80.9;79.5;58.4;0.5
FR;2022-03-16;2941;5840;18011;16285;54293817;53364846;39215676;360724;80.9;79.5;58.4;0.5
FR;2022-03-17;1369;2497;11929;13293;54295186;53367343;39227605;374017;80.9;79.5;58.4;0.6
FR;2022-03-18;2197;3844;18018;22011;54297383;53371187;39245623;396028;80.9;79.5;58.5;0.6
FR;2022-03-19;2274;3995;12398;11402;54299657;53375182;39258021;407430;80.9;79.5;58.5;0.6
FR;2022-03-20;291;501;1915;1332;54299948;53375683;39259936;408762;80.9;79.5;58.5;0.6
FR;2022-03-21;1339;2054;11908;16898;54301287;53377737;39271844;425660;80.9;79.5;58.5;0.6
FR;2022-03-22;1456;2410;12507;22811;54302743;53380147;39284351;448471;80.9;79.5;58.5;0.7
FR;2022-03-23;2632;4999;17141;25242;54305375;53385146;39301492;473713;80.9;79.5;58.6;0.7
FR;2022-03-24;1352;2009;10611;19350;54306727;53387155;39312103;493063;80.9;79.5;58.6;0.7
FR;2022-03-25;2044;3327;16812;30770;54308771;53390482;39328915;523833;80.9;79.6;58.6;0.8
FR;2022-03-26;2214;3691;11496;14377;54310985;53394173;39340411;538210;80.9;79.6;58.6;0.8
FR;2022-03-27;353;500;1908;1730;54311338;53394673;39342319;539940;80.9;79.6;58.6;0.8
FR;2022-03-28;1409;1951;10540;19024;54312747;53396624;39352859;558964;80.9;79.6;58.6;0.8
FR;2022-03-29;1419;2022;12003;29230;54314166;53398646;39364862;588194;80.9;79.6;58.7;0.9
FR;2022-03-30;2807;4541;14986;29249;54316973;53403187;39379848;617443;80.9;79.6;58.7;0.9
FR;2022-03-31;1588;2112;12173;26471;54318561;53405299;39392021;643914;80.9;79.6;58.7;1.0
FR;2022-04-01;2075;2646;18588;33405;54320636;53407945;39410609;677319;80.9;79.6;58.7;1.0
FR;2022-04-02;1490;1965;8674;11267;54322126;53409910;39419283;688586;80.9;79.6;58.7;1.0
FR;2022-04-03;272;338;1570;1378;54322398;53410248;39420853;689964;80.9;79.6;58.7;1.0
FR;2022-04-04;1312;1550;11337;20519;54323710;53411798;39432190;710483;80.9;79.6;58.8;1.1
FR;2022-04-05;1577;1786;13068;35582;54325287;53413584;39445258;746065;80.9;79.6;58.8;1.1
FR;2022-04-06;2022;2676;12639;27772;54327309;53416260;39457897;773837;80.9;79.6;58.8;1.2
FR;2022-04-07;1416;1685;12767;34911;54328725;53417945;39470664;808748;80.9;79.6;58.8;1.2
FR;2022-04-08;2007;2392;17714;45993;54330732;53420337;39488378;854741;81.0;79.6;58.8;1.3
FR;2022-04-09;1342;1869;8833;14766;54332074;53422206;39497211;869507;81.0;79.6;58.9;1.3
FR;2022-04-10;271;363;1969;2254;54332345;53422569;39499180;871761;81.0;79.6;58.9;1.3
FR;2022-04-11;1170;1464;11398;24897;54333515;53424033;39510578;896658;81.0;79.6;58.9;1.3
FR;2022-04-12;1559;1649;13230;41393;54335074;53425682;39523808;938051;81.0;79.6;58.9;1.4
FR;2022-04-13;1834;2399;12865;33687;54336908;53428081;39536673;971738;81.0;79.6;58.9;1.4
FR;2022-04-14;1427;1583;12838;36537;54338335;53429664;39549511;1008275;81.0;79.6;58.9;1.5
FR;2022-04-15;1765;2045;14709;36851;54340100;53431709;39564220;1045126;81.0;79.6;58.9;1.6
FR;2022-04-16;1025;1231;6208;9402;54341125;53432940;39570428;1054528;81.0;79.6;59.0;1.6
FR;2022-04-17;183;198;1027;1223;54341308;53433138;39571455;1055751;81.0;79.6;59.0;1.6
FR;2022-04-18;141;229;2736;1247;54341449;53433367;39574191;1056998;81.0;79.6;59.0;1.6
FR;2022-04-19;1458;1738;12317;30402;54342907;53435105;39586508;1087400;81.0;79.6;59.0;1.6
FR;2022-04-20;1883;2412;12784;29654;54344790;53437517;39599292;1117054;81.0;79.6;59.0;1.7
FR;2022-04-21;1464;1677;12404;35280;54346254;53439194;39611696;1152334;81.0;79.6;59.0;1.7
FR;2022-04-22;1810;2208;15718;38843;54348064;53441402;39627414;1191177;81.0;79.6;59.0;1.8
FR;2022-04-23;1108;1434;7191;11413;54349172;53442836;39634605;1202590;81.0;79.6;59.1;1.8
FR;2022-04-24;232;301;1396;1828;54349404;53443137;39636001;1204418;81.0;79.6;59.1;1.8
FR;2022-04-25;1237;1492;10386;21829;54350641;53444629;39646387;1226247;81.0;79.6;59.1;1.8
FR;2022-04-26;1541;1861;12978;38903;54352182;53446490;39659365;1265150;81.0;79.6;59.1;1.9
FR;2022-04-27;1884;2184;11433;30916;54354066;53448674;39670798;1296066;81.0;79.6;59.1;1.9
FR;2022-04-28;1510;1691;12081;35923;54355576;53450365;39682879;1331989;81.0;79.6;59.1;2.0
FR;2022-04-29;1931;2202;14674;38242;54357507;53452567;39697553;1370231;81.0;79.6;59.1;2.0
FR;2022-04-30;1171;1258;6559;10520;54358678;53453825;39704112;1380751;81.0;79.6;59.2;2.1
FR;2022-05-01;168;198;861;1081;54358846;53454023;39704973;1381832;81.0;79.6;59.2;2.1
FR;2022-05-02;1121;1235;10268;18570;54359967;53455258;39715241;1400402;81.0;79.6;59.2;2.1
FR;2022-05-03;1699;1701;12989;34869;54361666;53456959;39728230;1435271;81.0;79.6;59.2;2.1
FR;2022-05-04;1778;1882;11344;25569;54363444;53458841;39739574;1460840;81.0;79.7;59.2;2.2
FR;2022-05-05;1573;1610;11628;33442;54365017;53460451;39751202;1494282;81.0;79.7;59.2;2.2
FR;2022-05-06;2014;2124;14279;37787;54367031;53462575;39765481;1532069;81.0;79.7;59.2;2.3
FR;2022-05-07;1155;1203;6147;10239;54368186;53463778;39771628;1542308;81.0;79.7;59.3;2.3
FR;2022-05-08;249;259;1143;1609;54368435;53464037;39772771;1543917;81.0;79.7;59.3;2.3
FR;2022-05-09;1208;1168;8685;20602;54369643;53465205;39781456;1564519;81.0;79.7;59.3;2.3
FR;2022-05-10;1593;1650;11814;38960;54371236;53466855;39793270;1603479;81.0;79.7;59.3;2.4
FR;2022-05-11;1890;1942;9780;27758;54373126;53468797;39803050;1631237;81.0;79.7;59.3;2.4
FR;2022-05-12;1482;1515;10352;35579;54374608;53470312;39813402;1666816;81.0;79.7;59.3;2.5
FR;2022-05-13;1882;1860;12581;38201;54376490;53472172;39825983;1705017;81.0;79.7;59.3;2.5
FR;2022-05-14;1106;1091;5308;11181;54377596;53473263;39831291;1716198;81.0;79.7;59.3;2.6
FR;2022-05-15;256;212;1197;1530;54377852;53473475;39832488;1717728;81.0;79.7;59.3;2.6
FR;2022-05-16;1104;1029;7218;20670;54378956;53474504;39839706;1738398;81.0;79.7;59.4;2.6
FR;2022-05-17;1491;1451;9950;37319;54380447;53475955;39849656;1775717;81.0;79.7;59.4;2.6
FR;2022-05-18;1692;1711;8294;26535;54382139;53477666;39857950;1802252;81.0;79.7;59.4;2.7
FR;2022-05-19;1333;1372;9177;33889;54383472;53479038;39867127;1836141;81.0;79.7;59.4;2.7
FR;2022-05-20;1739;1767;11073;38401;54385211;53480805;39878200;1874542;81.0;79.7;59.4;2.8
FR;2022-05-21;1104;1166;4795;10011;54386315;53481971;39882995;1884553;81.0;79.7;59.4;2.8
FR;2022-05-22;200;202;895;1313;54386515;53482173;39883890;1885866;81.0;79.7;59.4;2.8
