fra;jour;n_dose1;n_complet;n_rappel;n_2_rappel;n_cum_dose1;n_cum_complet;n_cum_rappel;n_cum_2_rappel;couv_dose1;couv_complet;couv_rappel;couv_2_rappel
FR;2020-12-27;602;55;0;0;602;55;0;0;0.0;0.0;0.0;0.0
FR;2020-12-28;663;42;0;0;1265;97;0;0;0.0;0.0;0.0;0.0
FR;2020-12-29;371;19;0;0;1636;116;0;0;0.0;0.0;0.0;0.0
FR;2020-12-30;437;18;0;0;2073;134;0;0;0.0;0.0;0.0;0.0
FR;2020-12-31;413;22;0;0;2486;156;0;0;0.0;0.0;0.0;0.0
FR;2021-01-01;1135;64;0;0;3621;220;0;0;0.0;0.0;0.0;0.0
FR;2021-01-02;356;30;0;0;3977;250;0;0;0.0;0.0;0.0;0.0
FR;2021-01-03;399;27;0;0;4376;277;0;0;0.0;0.0;0.0;0.0
FR;2021-01-04;2086;48;0;0;6462;325;0;0;0.0;0.0;0.0;0.0
FR;2021-01-05;7558;121;0;0;14020;446;0;0;0.0;0.0;0.0;0.0
FR;2021-01-06;12410;119;0;0;26430;565;0;0;0.0;0.0;0.0;0.0
FR;2021-01-07;29445;158;0;0;55875;723;0;0;0.1;0.0;0.0;0.0
FR;2021-01-08;37121;195;0;0;92996;918;0;0;0.1;0.0;0.0;0.0
FR;2021-01-09;11209;76;0;0;104205;994;0;0;0.2;0.0;0.0;0.0
FR;2021-01-10;5996;24;0;0;110201;1018;0;0;0.2;0.0;0.0;0.0
FR;2021-01-11;39922;226;0;0;150123;1244;0;0;0.2;0.0;0.0;0.0
FR;2021-01-12;62119;310;0;0;212242;1554;0;0;0.3;0.0;0.0;0.0
FR;2021-01-13;65096;435;0;0;277338;1989;0;0;0.4;0.0;0.0;0.0
FR;2021-01-14;83123;1191;0;0;360461;3180;0;0;0.5;0.0;0.0;0.0
FR;2021-01-15;68986;559;0;0;429447;3739;0;0;0.6;0.0;0.0;0.0
FR;2021-01-16;20208;189;0;0;449655;3928;0;0;0.7;0.0;0.0;0.0
FR;2021-01-17;10976;131;0;0;460631;4059;0;0;0.7;0.0;0.0;0.0
FR;2021-01-18;85874;614;0;0;546505;4673;0;0;0.8;0.0;0.0;0.0
FR;2021-01-19;130571;864;0;0;677076;5537;0;0;1.0;0.0;0.0;0.0
FR;2021-01-20;137523;851;0;0;814599;6388;0;0;1.2;0.0;0.0;0.0
FR;2021-01-21;158368;971;0;0;972967;7359;0;0;1.4;0.0;0.0;0.0
FR;2021-01-22;121038;831;0;0;1094005;8190;0;0;1.6;0.0;0.0;0.0
FR;2021-01-23;38464;203;0;0;1132469;8393;0;0;1.7;0.0;0.0;0.0
FR;2021-01-24;9740;134;0;0;1142209;8527;0;0;1.7;0.0;0.0;0.0
FR;2021-01-25;78216;1630;0;0;1220425;10157;0;0;1.8;0.0;0.0;0.0
FR;2021-01-26;100358;3759;0;0;1320783;13916;0;0;2.0;0.0;0.0;0.0
FR;2021-01-27;107222;6642;0;0;1428005;20558;0;0;2.1;0.0;0.0;0.0
FR;2021-01-28;124322;15749;0;0;1552327;36307;0;0;2.3;0.1;0.0;0.0
FR;2021-01-29;92168;18255;0;0;1644495;54562;0;0;2.5;0.1;0.0;0.0
FR;2021-01-30;29110;4373;0;0;1673605;58935;0;0;2.5;0.1;0.0;0.0
FR;2021-01-31;5225;1766;0;0;1678830;60701;0;0;2.5;0.1;0.0;0.0
FR;2021-02-01;53103;21743;0;0;1731933;82444;0;0;2.6;0.1;0.0;0.0
FR;2021-02-02;72274;36098;0;0;1804207;118542;0;0;2.7;0.2;0.0;0.0
FR;2021-02-03;72284;38327;0;0;1876491;156869;0;0;2.8;0.2;0.0;0.0
FR;2021-02-04;82047;51949;0;0;1958538;208818;0;0;2.9;0.3;0.0;0.0
FR;2021-02-05;68216;46412;0;0;2026754;255230;0;0;3.0;0.4;0.0;0.0
FR;2021-02-06;23113;10959;0;0;2049867;266189;0;0;3.1;0.4;0.0;0.0
FR;2021-02-07;5181;5357;0;0;2055048;271546;0;0;3.1;0.4;0.0;0.0
FR;2021-02-08;46815;47227;0;0;2101863;318773;0;0;3.1;0.5;0.0;0.0
FR;2021-02-09;65990;75232;0;0;2167853;394005;0;0;3.2;0.6;0.0;0.0
FR;2021-02-10;70980;80282;0;0;2238833;474287;0;0;3.3;0.7;0.0;0.0
FR;2021-02-11;87235;102712;0;0;2326068;576999;0;0;3.5;0.9;0.0;0.0
FR;2021-02-12;79286;76511;0;0;2405354;653510;0;0;3.6;1.0;0.0;0.0
FR;2021-02-13;22351;19792;0;0;2427705;673302;0;0;3.6;1.0;0.0;0.0
FR;2021-02-14;5070;7296;0;0;2432775;680598;0;0;3.6;1.0;0.0;0.0
FR;2021-02-15;38068;77373;0;0;2470843;757971;0;0;3.7;1.1;0.0;0.0
FR;2021-02-16;50361;101636;0;0;2521204;859607;0;0;3.8;1.3;0.0;0.0
FR;2021-02-17;50495;105744;0;0;2571699;965351;0;0;3.8;1.4;0.0;0.0
FR;2021-02-18;69755;122006;0;0;2641454;1087357;0;0;3.9;1.6;0.0;0.0
FR;2021-02-19;65048;92688;0;0;2706502;1180045;0;0;4.0;1.8;0.0;0.0
FR;2021-02-20;18573;28855;0;0;2725075;1208900;0;0;4.1;1.8;0.0;0.0
FR;2021-02-21;3314;6407;0;0;2728389;1215307;0;0;4.1;1.8;0.0;0.0
FR;2021-02-22;37476;73925;0;0;2765865;1289232;0;0;4.1;1.9;0.0;0.0
FR;2021-02-23;53758;85778;0;0;2819623;1375010;0;0;4.2;2.0;0.0;0.0
FR;2021-02-24;59977;83037;0;0;2879600;1458047;0;0;4.3;2.2;0.0;0.0
FR;2021-02-25;100541;94237;0;0;2980141;1552284;0;0;4.4;2.3;0.0;0.0
FR;2021-02-26;113422;73748;0;0;3093563;1626032;0;0;4.6;2.4;0.0;0.0
FR;2021-02-27;52091;23346;0;0;3145654;1649378;0;0;4.7;2.5;0.0;0.0
FR;2021-02-28;6190;4480;0;0;3151844;1653858;0;0;4.7;2.5;0.0;0.0
FR;2021-03-01;65828;55073;0;0;3217672;1708931;0;0;4.8;2.5;0.0;0.0
FR;2021-03-02;101345;69488;0;0;3319017;1778419;0;0;4.9;2.6;0.0;0.0
FR;2021-03-03;116459;69093;0;0;3435476;1847512;0;0;5.1;2.8;0.0;0.0
FR;2021-03-04;163580;75616;0;0;3599056;1923128;0;0;5.4;2.9;0.0;0.0
FR;2021-03-05;200881;69777;0;0;3799937;1992905;0;0;5.7;3.0;0.0;0.0
FR;2021-03-06;207921;23031;0;0;4007858;2015936;0;0;6.0;3.0;0.0;0.0
FR;2021-03-07;121250;8306;0;0;4129108;2024242;0;0;6.2;3.0;0.0;0.0
FR;2021-03-08;107110;53796;0;0;4236218;2078038;0;0;6.3;3.1;0.0;0.0
FR;2021-03-09;172409;61909;0;0;4408627;2139947;0;0;6.6;3.2;0.0;0.0
FR;2021-03-10;178932;62714;0;0;4587559;2202661;0;0;6.8;3.3;0.0;0.0
FR;2021-03-11;242820;71437;0;0;4830379;2274098;0;0;7.2;3.4;0.0;0.0
FR;2021-03-12;294771;62817;0;0;5125150;2336915;0;0;7.6;3.5;0.0;0.0
FR;2021-03-13;231370;21295;0;0;5356520;2358210;0;0;8.0;3.5;0.0;0.0
FR;2021-03-14;63334;5342;0;0;5419854;2363552;0;0;8.1;3.5;0.0;0.0
FR;2021-03-15;158598;36802;0;0;5578452;2400354;0;0;8.3;3.6;0.0;0.0
FR;2021-03-16;141538;43229;0;0;5719990;2443583;0;0;8.5;3.6;0.0;0.0
FR;2021-03-17;150440;42935;0;0;5870430;2486518;0;0;8.7;3.7;0.0;0.0
FR;2021-03-18;167777;50014;0;0;6038207;2536532;0;0;9.0;3.8;0.0;0.0
FR;2021-03-19;229961;44512;0;0;6268168;2581044;0;0;9.3;3.8;0.0;0.0
FR;2021-03-20;166639;16224;0;0;6434807;2597268;0;0;9.6;3.9;0.0;0.0
FR;2021-03-21;49918;4281;0;0;6484725;2601549;0;0;9.7;3.9;0.0;0.0
FR;2021-03-22;169992;39465;0;0;6654717;2641014;0;0;9.9;3.9;0.0;0.0
FR;2021-03-23;250329;50171;0;0;6905046;2691185;0;0;10.3;4.0;0.0;0.0
FR;2021-03-24;256846;51731;0;0;7161892;2742916;0;0;10.7;4.1;0.0;0.0
FR;2021-03-25;341745;55786;0;0;7503637;2798702;0;0;11.2;4.2;0.0;0.0
FR;2021-03-26;358743;53537;0;0;7862380;2852239;0;0;11.7;4.2;0.0;0.0
FR;2021-03-27;195238;23140;0;0;8057618;2875379;0;0;12.0;4.3;0.0;0.0
FR;2021-03-28;59321;6051;0;0;8116939;2881430;0;0;12.1;4.3;0.0;0.0
FR;2021-03-29;202926;60696;0;0;8319865;2942126;0;0;12.4;4.4;0.0;0.0
FR;2021-03-30;285406;79987;0;0;8605271;3022113;0;0;12.8;4.5;0.0;0.0
FR;2021-03-31;262962;83801;0;0;8868233;3105914;0;0;13.2;4.6;0.0;0.0
FR;2021-04-01;315379;102625;0;0;9183612;3208539;0;0;13.7;4.8;0.0;0.0
FR;2021-04-02;281274;104466;0;0;9464886;3313005;0;0;14.1;4.9;0.0;0.0
FR;2021-04-03;141046;67115;0;0;9605932;3380120;0;0;14.3;5.0;0.0;0.0
FR;2021-04-04;46448;20773;0;0;9652380;3400893;0;0;14.4;5.1;0.0;0.0
FR;2021-04-05;63304;13461;0;0;9715684;3414354;0;0;14.5;5.1;0.0;0.0
FR;2021-04-06;217139;117844;0;0;9932823;3532198;0;0;14.8;5.3;0.0;0.0
FR;2021-04-07;260184;126594;0;0;10193007;3658792;0;0;15.2;5.5;0.0;0.0
FR;2021-04-08;337730;137160;0;0;10530737;3795952;0;0;15.7;5.7;0.0;0.0
FR;2021-04-09;410076;133581;0;0;10940813;3929533;0;0;16.3;5.9;0.0;0.0
FR;2021-04-10;212579;90942;0;0;11153392;4020475;0;0;16.6;6.0;0.0;0.0
FR;2021-04-11;56121;36946;0;0;11209513;4057421;0;0;16.7;6.0;0.0;0.0
FR;2021-04-12;236995;124712;0;0;11446508;4182133;0;0;17.1;6.2;0.0;0.0
FR;2021-04-13;309415;157378;0;0;11755923;4339511;0;0;17.5;6.5;0.0;0.0
FR;2021-04-14;294430;152546;0;0;12050353;4492057;0;0;18.0;6.7;0.0;0.0
FR;2021-04-15;337002;163728;0;0;12387355;4655785;0;0;18.5;6.9;0.0;0.0
FR;2021-04-16;339221;160431;0;0;12726576;4816216;0;0;19.0;7.2;0.0;0.0
FR;2021-04-17;188619;97665;0;0;12915195;4913881;0;0;19.2;7.3;0.0;0.0
FR;2021-04-18;51600;37779;0;0;12966795;4951660;0;0;19.3;7.4;0.0;0.0
FR;2021-04-19;205639;147247;0;0;13172434;5098907;0;0;19.6;7.6;0.0;0.0
FR;2021-04-20;254340;182335;0;0;13426774;5281242;0;0;20.0;7.9;0.0;0.0
FR;2021-04-21;253173;180987;0;0;13679947;5462229;0;0;20.4;8.1;0.0;0.0
FR;2021-04-22;287485;203161;0;0;13967432;5665390;0;0;20.8;8.4;0.0;0.0
FR;2021-04-23;297923;202416;0;0;14265355;5867806;0;0;21.3;8.7;0.0;0.0
FR;2021-04-24;190407;121939;0;0;14455762;5989745;0;0;21.5;8.9;0.0;0.0
FR;2021-04-25;69536;42505;0;0;14525298;6032250;0;0;21.6;9.0;0.0;0.0
FR;2021-04-26;220889;169366;0;0;14746187;6201616;0;0;22.0;9.2;0.0;0.0
FR;2021-04-27;284543;210547;0;0;15030730;6412163;0;0;22.4;9.6;0.0;0.0
FR;2021-04-28;299431;208210;1;0;15330161;6620373;1;0;22.8;9.9;0.0;0.0
FR;2021-04-29;357051;231474;0;0;15687212;6851847;1;0;23.4;10.2;0.0;0.0
FR;2021-04-30;372130;224049;0;0;16059342;7075896;1;0;23.9;10.5;0.0;0.0
FR;2021-05-01;167595;63731;0;0;16226937;7139627;1;0;24.2;10.6;0.0;0.0
FR;2021-05-02;91699;43447;0;0;16318636;7183074;1;0;24.3;10.7;0.0;0.0
FR;2021-05-03;288848;188950;0;0;16607484;7372024;1;0;24.7;11.0;0.0;0.0
FR;2021-05-04;315582;250474;0;0;16923066;7622498;1;0;25.2;11.4;0.0;0.0
FR;2021-05-05;327088;249664;0;0;17250154;7872162;1;0;25.7;11.7;0.0;0.0
FR;2021-05-06;379416;273555;0;0;17629570;8145717;1;0;26.3;12.1;0.0;0.0
FR;2021-05-07;372674;298213;0;0;18002244;8443930;1;0;26.8;12.6;0.0;0.0
FR;2021-05-08;222132;82489;0;0;18224376;8526419;1;0;27.2;12.7;0.0;0.0
FR;2021-05-09;129684;55042;0;0;18354060;8581461;1;0;27.3;12.8;0.0;0.0
FR;2021-05-10;313292;254373;0;0;18667352;8835834;1;0;27.8;13.2;0.0;0.0
FR;2021-05-11;403807;296159;0;0;19071159;9131993;1;0;28.4;13.6;0.0;0.0
FR;2021-05-12;434024;269208;0;0;19505183;9401201;1;0;29.1;14.0;0.0;0.0
FR;2021-05-13;338542;78408;0;0;19843725;9479609;1;0;29.6;14.1;0.0;0.0
FR;2021-05-14;454049;202753;0;0;20297774;9682362;1;0;30.2;14.4;0.0;0.0
FR;2021-05-15;374916;120370;0;0;20672690;9802732;1;0;30.8;14.6;0.0;0.0
FR;2021-05-16;202717;34177;0;0;20875407;9836909;1;0;31.1;14.7;0.0;0.0
FR;2021-05-17;376054;178559;0;0;21251461;10015468;1;0;31.7;14.9;0.0;0.0
FR;2021-05-18;460054;192183;0;0;21711515;10207651;1;0;32.3;15.2;0.0;0.0
FR;2021-05-19;467314;182029;0;0;22178829;10389680;1;0;33.0;15.5;0.0;0.0
FR;2021-05-20;507393;204133;0;0;22686222;10593813;1;0;33.8;15.8;0.0;0.0
FR;2021-05-21;489550;220817;0;0;23175772;10814630;1;0;34.5;16.1;0.0;0.0
FR;2021-05-22;347137;108262;0;0;23522909;10922892;1;0;35.0;16.3;0.0;0.0
FR;2021-05-23;161636;26882;0;0;23684545;10949774;1;0;35.3;16.3;0.0;0.0
FR;2021-05-24;263129;53015;0;0;23947674;11002789;1;0;35.7;16.4;0.0;0.0
FR;2021-05-25;400135;225650;0;0;24347809;11228439;1;0;36.3;16.7;0.0;0.0
FR;2021-05-26;413355;226409;0;0;24761164;11454848;1;0;36.9;17.1;0.0;0.0
FR;2021-05-27;449697;265624;0;0;25210861;11720472;1;0;37.6;17.5;0.0;0.0
FR;2021-05-28;429442;317400;0;0;25640303;12037872;1;0;38.2;17.9;0.0;0.0
FR;2021-05-29;298939;182118;0;0;25939242;12219990;1;0;38.6;18.2;0.0;0.0
FR;2021-05-30;107095;42161;0;0;26046337;12262151;1;0;38.8;18.3;0.0;0.0
FR;2021-05-31;357910;241602;1;0;26404247;12503753;2;0;39.3;18.6;0.0;0.0
FR;2021-06-01;430830;302812;1;0;26835077;12806565;3;0;40.0;19.1;0.0;0.0
FR;2021-06-02;419284;278109;0;0;27254361;13084674;3;0;40.6;19.5;0.0;0.0
FR;2021-06-03;464538;313044;0;0;27718899;13397718;3;0;41.3;20.0;0.0;0.0
FR;2021-06-04;455682;361984;1;0;28174581;13759702;4;0;42.0;20.5;0.0;0.0
FR;2021-06-05;304744;222116;0;0;28479325;13981818;4;0;42.4;20.8;0.0;0.0
FR;2021-06-06;133235;61272;0;0;28612560;14043090;4;0;42.6;20.9;0.0;0.0
FR;2021-06-07;338964;298998;0;0;28951524;14342088;4;0;43.1;21.4;0.0;0.0
FR;2021-06-08;393557;337756;0;0;29345081;14679844;4;0;43.7;21.9;0.0;0.0
FR;2021-06-09;384656;319858;0;0;29729737;14999702;4;0;44.3;22.3;0.0;0.0
FR;2021-06-10;403955;338322;0;0;30133692;15338024;4;0;44.9;22.9;0.0;0.0
FR;2021-06-11;386460;407554;0;0;30520152;15745578;4;0;45.5;23.5;0.0;0.0
FR;2021-06-12;283202;243395;0;0;30803354;15988973;4;0;45.9;23.8;0.0;0.0
FR;2021-06-13;104828;84983;0;0;30908182;16073956;4;0;46.1;23.9;0.0;0.0
FR;2021-06-14;240646;384650;0;0;31148828;16458606;4;0;46.4;24.5;0.0;0.0
FR;2021-06-15;307971;424332;0;0;31456799;16882938;4;0;46.9;25.2;0.0;0.0
FR;2021-06-16;313833;395491;0;0;31770632;17278429;4;0;47.3;25.7;0.0;0.0
FR;2021-06-17;317551;413548;0;0;32088183;17691977;4;0;47.8;26.4;0.0;0.0
FR;2021-06-18;321551;485739;0;0;32409734;18177716;4;0;48.3;27.1;0.0;0.0
FR;2021-06-19;224305;300949;0;0;32634039;18478665;4;0;48.6;27.5;0.0;0.0
FR;2021-06-20;74366;111783;0;0;32708405;18590448;4;0;48.7;27.7;0.0;0.0
FR;2021-06-21;195561;427737;1;0;32903966;19018185;5;0;49.0;28.3;0.0;0.0
FR;2021-06-22;222998;499982;2;0;33126964;19518167;7;0;49.4;29.1;0.0;0.0
FR;2021-06-23;233863;474043;1;0;33360827;19992210;8;0;49.7;29.8;0.0;0.0
FR;2021-06-24;241723;447080;0;0;33602550;20439290;8;0;50.1;30.5;0.0;0.0
FR;2021-06-25;227460;561192;0;0;33830010;21000482;8;0;50.4;31.3;0.0;0.0
FR;2021-06-26;153191;395472;0;0;33983201;21395954;8;0;50.6;31.9;0.0;0.0
FR;2021-06-27;55861;165127;0;0;34039062;21561081;8;0;50.7;32.1;0.0;0.0
FR;2021-06-28;154610;478404;0;0;34193672;22039485;8;0;50.9;32.8;0.0;0.0
FR;2021-06-29;182537;538266;0;0;34376209;22577751;8;0;51.2;33.6;0.0;0.0
FR;2021-06-30;203832;516739;2;0;34580041;23094490;10;0;51.5;34.4;0.0;0.0
FR;2021-07-01;231094;497943;1;0;34811135;23592433;11;0;51.9;35.2;0.0;0.0
FR;2021-07-02;228290;562675;3;0;35039425;24155108;14;0;52.2;36.0;0.0;0.0
FR;2021-07-03;141928;395314;1;0;35181353;24550422;15;0;52.4;36.6;0.0;0.0
FR;2021-07-04;56689;150978;0;0;35238042;24701400;15;0;52.5;36.8;0.0;0.0
FR;2021-07-05;168202;449388;2;0;35406244;25150788;17;0;52.8;37.5;0.0;0.0
FR;2021-07-06;196542;511533;8;0;35602786;25662321;25;0;53.0;38.2;0.0;0.0
FR;2021-07-07;212917;477922;5;0;35815703;26140243;30;0;53.4;38.9;0.0;0.0
FR;2021-07-08;231433;468294;7;0;36047136;26608537;37;0;53.7;39.6;0.0;0.0
FR;2021-07-09;228338;557176;2;0;36275474;27165713;39;0;54.0;40.5;0.0;0.0
FR;2021-07-10;148531;368894;1;0;36424005;27534607;40;0;54.3;41.0;0.0;0.0
FR;2021-07-11;60140;121095;0;0;36484145;27655702;40;0;54.4;41.2;0.0;0.0
FR;2021-07-12;168951;513166;0;0;36653096;28168868;40;0;54.6;42.0;0.0;0.0
FR;2021-07-13;287045;586701;2;0;36940141;28755569;42;0;55.0;42.8;0.0;0.0
FR;2021-07-14;180875;187154;0;0;37121016;28942723;42;0;55.3;43.1;0.0;0.0
FR;2021-07-15;346852;572750;0;0;37467868;29515473;42;0;55.8;44.0;0.0;0.0
FR;2021-07-16;379898;575413;1;0;37847766;30090886;43;0;56.4;44.8;0.0;0.0
FR;2021-07-17;259648;368945;0;0;38107414;30459831;43;0;56.8;45.4;0.0;0.0
FR;2021-07-18;109663;133309;0;0;38217077;30593140;43;0;56.9;45.6;0.0;0.0
FR;2021-07-19;285308;480287;0;0;38502385;31073427;43;0;57.4;46.3;0.0;0.0
FR;2021-07-20;376712;524978;0;0;38879097;31598405;43;0;57.9;47.1;0.0;0.0
FR;2021-07-21;395620;483147;2;0;39274717;32081552;45;0;58.5;47.8;0.0;0.0
FR;2021-07-22;440873;472850;2;0;39715590;32554402;47;0;59.2;48.5;0.0;0.0
FR;2021-07-23;439809;511388;2;0;40155399;33065790;49;0;59.8;49.3;0.0;0.0
FR;2021-07-24;285177;322368;0;0;40440576;33388158;49;0;60.3;49.7;0.0;0.0
FR;2021-07-25;121051;100470;0;0;40561627;33488628;49;0;60.4;49.9;0.0;0.0
FR;2021-07-26;347248;385974;2;0;40908875;33874602;51;0;61.0;50.5;0.0;0.0
FR;2021-07-27;463878;401706;2;0;41372753;34276308;53;0;61.6;51.1;0.0;0.0
FR;2021-07-28;459288;367905;2;0;41832041;34644213;55;0;62.3;51.6;0.0;0.0
FR;2021-07-29;489676;358083;1;0;42321717;35002296;56;0;63.1;52.2;0.0;0.0
FR;2021-07-30;461624;381663;2;0;42783341;35383959;58;0;63.7;52.7;0.0;0.0
FR;2021-07-31;285338;231697;0;0;43068679;35615656;58;0;64.2;53.1;0.0;0.0
FR;2021-08-01;111933;65838;0;0;43180612;35681494;58;0;64.3;53.2;0.0;0.0
FR;2021-08-02;341202;285574;0;0;43521814;35967068;58;0;64.8;53.6;0.0;0.0
FR;2021-08-03;398387;305470;1;0;43920201;36272538;59;0;65.4;54.0;0.0;0.0
FR;2021-08-04;384611;266521;3;0;44304812;36539059;62;0;66.0;54.4;0.0;0.0
FR;2021-08-05;365972;282625;0;0;44670784;36821684;62;0;66.6;54.9;0.0;0.0
FR;2021-08-06;359542;327406;1;0;45030326;37149090;63;0;67.1;55.4;0.0;0.0
FR;2021-08-07;213032;210267;3;0;45243358;37359357;66;0;67.4;55.7;0.0;0.0
FR;2021-08-08;74128;73747;0;0;45317486;37433104;66;0;67.5;55.8;0.0;0.0
FR;2021-08-09;258569;298693;3;0;45576055;37731797;69;0;67.9;56.2;0.0;0.0
FR;2021-08-10;306587;324711;1;0;45882642;38056508;70;0;68.4;56.7;0.0;0.0
FR;2021-08-11;279514;302650;1;0;46162156;38359158;71;0;68.8;57.2;0.0;0.0
FR;2021-08-12;271363;321209;1;0;46433519;38680367;72;0;69.2;57.6;0.0;0.0
FR;2021-08-13;252028;317021;2;0;46685547;38997388;74;0;69.6;58.1;0.0;0.0
FR;2021-08-14;145272;219429;0;0;46830819;39216817;74;0;69.8;58.4;0.0;0.0
FR;2021-08-15;39298;55728;0;0;46870117;39272545;74;0;69.8;58.5;0.0;0.0
FR;2021-08-16;186033;346358;0;0;47056150;39618903;74;0;70.1;59.0;0.0;0.0
FR;2021-08-17;215551;369947;1;0;47271701;39988850;75;0;70.4;59.6;0.0;0.0
FR;2021-08-18;198915;355277;4;0;47470616;40344127;79;0;70.7;60.1;0.0;0.0
FR;2021-08-19;191875;356638;0;0;47662491;40700765;79;0;71.0;60.6;0.0;0.0
FR;2021-08-20;186335;397172;2;0;47848826;41097937;81;0;71.3;61.2;0.0;0.0
FR;2021-08-21;104746;254751;0;0;47953572;41352688;81;0;71.4;61.6;0.0;0.0
FR;2021-08-22;31885;92209;1;0;47985457;41444897;82;0;71.5;61.8;0.0;0.0
FR;2021-08-23;140882;380223;2;0;48126339;41825120;84;0;71.7;62.3;0.0;0.0
FR;2021-08-24;162398;403604;1;0;48288737;42228724;85;0;71.9;62.9;0.0;0.0
FR;2021-08-25;151057;376065;3;0;48439794;42604789;88;0;72.2;63.5;0.0;0.0
FR;2021-08-26;142731;368370;1;0;48582525;42973159;89;0;72.4;64.0;0.0;0.0
FR;2021-08-27;148359;415542;3;0;48730884;43388701;92;0;72.6;64.6;0.0;0.0
FR;2021-08-28;90599;265287;0;0;48821483;43653988;92;0;72.7;65.0;0.0;0.0
FR;2021-08-29;27304;88402;0;0;48848787;43742390;92;0;72.8;65.2;0.0;0.0
FR;2021-08-30;117321;342667;6026;1;48966108;44085057;6118;1;73.0;65.7;0.0;0.0
FR;2021-08-31;128713;354214;11883;2;49094821;44439271;18001;3;73.2;66.2;0.0;0.0
FR;2021-09-01;135727;302704;24305;3;49230548;44741975;42306;6;73.4;66.7;0.1;0.0
FR;2021-09-02;112577;262496;28849;1;49343125;45004471;71155;7;73.5;67.1;0.1;0.0
FR;2021-09-03;118164;309716;32962;6;49461289;45314187;104117;13;73.7;67.5;0.2;0.0
FR;2021-09-04;89793;230672;14069;5;49551082;45544859;118186;18;73.8;67.9;0.2;0.0
FR;2021-09-05;21334;48361;4730;0;49572416;45593220;122916;18;73.9;67.9;0.2;0.0
FR;2021-09-06;75315;191212;34240;2;49647731;45784432;157156;20;74.0;68.2;0.2;0.0
FR;2021-09-07;80045;191511;36091;3;49727776;45975943;193247;23;74.1;68.5;0.3;0.0
FR;2021-09-08;89656;216952;32455;6;49817432;46192895;225702;29;74.2;68.8;0.3;0.0
FR;2021-09-09;76634;174522;36520;16;49894066;46367417;262222;45;74.3;69.1;0.4;0.0
FR;2021-09-10;95564;215262;40504;13;49989630;46582679;302726;58;74.5;69.4;0.5;0.0
FR;2021-09-11;66726;178310;14306;1;50056356;46760989;317032;59;74.6;69.7;0.5;0.0
FR;2021-09-12;12791;34161;3160;2;50069147;46795150;320192;61;74.6;69.7;0.5;0.0
FR;2021-09-13;64365;134688;44042;29;50133512;46929838;364234;90;74.7;69.9;0.5;0.0
FR;2021-09-14;73295;136313;62012;52;50206807;47066151;426246;142;74.8;70.1;0.6;0.0
FR;2021-09-15;76399;174884;54772;100;50283206;47241035;481018;242;74.9;70.4;0.7;0.0
FR;2021-09-16;63751;117982;60012;126;50346957;47359017;541030;368;75.0;70.6;0.8;0.0
FR;2021-09-17;74960;159831;57221;94;50421917;47518848;598251;462;75.1;70.8;0.9;0.0
FR;2021-09-18;48185;144338;17282;24;50470102;47663186;615533;486;75.2;71.0;0.9;0.0
FR;2021-09-19;7863;24928;2621;3;50477965;47688114;618154;489;75.2;71.1;0.9;0.0
FR;2021-09-20;44435;96446;50249;56;50522400;47784560;668403;545;75.3;71.2;1.0;0.0
FR;2021-09-21;45802;98528;63356;128;50568202;47883088;731759;673;75.3;71.3;1.1;0.0
FR;2021-09-22;48580;144832;55342;67;50616782;48027920;787101;740;75.4;71.6;1.2;0.0
FR;2021-09-23;43154;91249;63465;123;50659936;48119169;850566;863;75.5;71.7;1.3;0.0
FR;2021-09-24;52195;132450;59084;105;50712131;48251619;909650;968;75.6;71.9;1.4;0.0
FR;2021-09-25;35192;118552;18251;27;50747323;48370171;927901;995;75.6;72.1;1.4;0.0
FR;2021-09-26;5524;18691;2330;5;50752847;48388862;930231;1000;75.6;72.1;1.4;0.0
FR;2021-09-27;33917;78892;48121;115;50786764;48467754;978352;1115;75.7;72.2;1.5;0.0
FR;2021-09-28;36444;74411;56456;86;50823208;48542165;1034808;1201;75.7;72.3;1.5;0.0
FR;2021-09-29;44311;103044;54803;78;50867519;48645209;1089611;1279;75.8;72.5;1.6;0.0
FR;2021-09-30;36265;71379;59467;90;50903784;48716588;1149078;1369;75.8;72.6;1.7;0.0
FR;2021-10-01;61505;99680;63677;54;50965289;48816268;1212755;1423;75.9;72.7;1.8;0.0
FR;2021-10-02;39412;81680;23318;18;51004701;48897948;1236073;1441;76.0;72.9;1.8;0.0
FR;2021-10-03;5261;11296;2539;4;51009962;48909244;1238612;1445;76.0;72.9;1.8;0.0
FR;2021-10-04;34933;59558;54772;82;51044895;48968802;1293384;1527;76.1;73.0;1.9;0.0
FR;2021-10-05;33538;62206;64908;75;51078433;49031008;1358292;1602;76.1;73.1;2.0;0.0
FR;2021-10-06;42404;80216;68206;43;51120837;49111224;1426498;1645;76.2;73.2;2.1;0.0
FR;2021-10-07;30388;59461;68654;88;51151225;49170685;1495152;1733;76.2;73.3;2.2;0.0
FR;2021-10-08;48726;89888;84608;71;51199951;49260573;1579760;1804;76.3;73.4;2.4;0.0
FR;2021-10-09;33620;64130;33852;21;51233571;49324703;1613612;1825;76.3;73.5;2.4;0.0
FR;2021-10-10;4586;7927;3483;2;51238157;49332630;1617095;1827;76.3;73.5;2.4;0.0
FR;2021-10-11;30548;50656;64021;94;51268705;49383286;1681116;1921;76.4;73.6;2.5;0.0
FR;2021-10-12;31320;51439;75823;59;51300025;49434725;1756939;1980;76.4;73.7;2.6;0.0
FR;2021-10-13;39975;62840;79240;51;51340000;49497565;1836179;2031;76.5;73.8;2.7;0.0
FR;2021-10-14;30219;49738;73754;49;51370219;49547303;1909933;2080;76.5;73.8;2.8;0.0
FR;2021-10-15;44729;70439;102886;60;51414948;49617742;2012819;2140;76.6;73.9;3.0;0.0
FR;2021-10-16;31269;46725;39606;24;51446217;49664467;2052425;2164;76.7;74.0;3.1;0.0
FR;2021-10-17;3826;5694;3691;3;51450043;49670161;2056116;2167;76.7;74.0;3.1;0.0
FR;2021-10-18;28247;42676;71333;37;51478290;49712837;2127449;2204;76.7;74.1;3.2;0.0
FR;2021-10-19;27039;42103;81600;72;51505329;49754940;2209049;2276;76.7;74.1;3.3;0.0
FR;2021-10-20;35197;51882;101452;94;51540526;49806822;2310501;2370;76.8;74.2;3.4;0.0
FR;2021-10-21;25919;42008;89099;45;51566445;49848830;2399600;2415;76.8;74.3;3.6;0.0
FR;2021-10-22;38184;59326;112474;91;51604629;49908156;2512074;2506;76.9;74.4;3.7;0.0
FR;2021-10-23;26960;42458;48594;24;51631589;49950614;2560668;2530;76.9;74.4;3.8;0.0
FR;2021-10-24;2912;5022;3937;3;51634501;49955636;2564605;2533;76.9;74.4;3.8;0.0
FR;2021-10-25;25972;35631;86594;67;51660473;49991267;2651199;2600;77.0;74.5;4.0;0.0
FR;2021-10-26;23680;32292;92303;48;51684153;50023559;2743502;2648;77.0;74.5;4.1;0.0
FR;2021-10-27;30003;44204;114603;73;51714156;50067763;2858105;2721;77.1;74.6;4.3;0.0
FR;2021-10-28;23373;31213;94361;62;51737529;50098976;2952466;2783;77.1;74.6;4.4;0.0
FR;2021-10-29;31498;46502;125236;80;51769027;50145478;3077702;2863;77.1;74.7;4.6;0.0
FR;2021-10-30;20520;32844;53352;27;51789547;50178322;3131054;2890;77.2;74.8;4.7;0.0
FR;2021-10-31;2477;3875;3867;3;51792024;50182197;3134921;2893;77.2;74.8;4.7;0.0
FR;2021-11-01;8190;4958;3551;10;51800214;50187155;3138472;2903;77.2;74.8;4.7;0.0
FR;2021-11-02;25263;36345;99459;64;51825477;50223500;3237931;2967;77.2;74.8;4.8;0.0
FR;2021-11-03;29743;43597;125770;97;51855220;50267097;3363701;3064;77.3;74.9;5.0;0.0
FR;2021-11-04;23658;31638;114312;68;51878878;50298735;3478013;3132;77.3;74.9;5.2;0.0
FR;2021-11-05;32262;44718;151246;85;51911140;50343453;3629259;3217;77.3;75.0;5.4;0.0
FR;2021-11-06;21477;32464;68220;41;51932617;50375917;3697479;3258;77.4;75.1;5.5;0.0
FR;2021-11-07;2377;4060;5583;8;51934994;50379977;3703062;3266;77.4;75.1;5.5;0.0
FR;2021-11-08;20393;31077;134150;73;51955387;50411054;3837212;3339;77.4;75.1;5.7;0.0
FR;2021-11-09;22120;33104;172097;107;51977507;50444158;4009309;3446;77.4;75.2;6.0;0.0
FR;2021-11-10;31350;44242;198663;129;52008857;50488400;4207972;3575;77.5;75.2;6.3;0.0
FR;2021-11-11;4291;5849;13924;20;52013148;50494249;4221896;3595;77.5;75.2;6.3;0.0
FR;2021-11-12;28982;41887;197253;128;52042130;50536136;4419149;3723;77.5;75.3;6.6;0.0
FR;2021-11-13;20288;28357;86288;60;52062418;50564493;4505437;3783;77.6;75.3;6.7;0.0
FR;2021-11-14;2323;3407;7877;10;52064741;50567900;4513314;3793;77.6;75.3;6.7;0.0
FR;2021-11-15;20285;28085;171437;103;52085026;50595985;4684751;3896;77.6;75.4;7.0;0.0
FR;2021-11-16;23326;28012;214860;152;52108352;50623997;4899611;4048;77.6;75.4;7.3;0.0
FR;2021-11-17;30337;36733;212775;132;52138689;50660730;5112386;4180;77.7;75.5;7.6;0.0
FR;2021-11-18;23340;28774;205388;123;52162029;50689504;5317774;4303;77.7;75.5;7.9;0.0
FR;2021-11-19;33550;40096;262060;186;52195579;50729600;5579834;4489;77.8;75.6;8.3;0.0
FR;2021-11-20;25313;29396;109656;63;52220892;50758996;5689490;4552;77.8;75.6;8.5;0.0
FR;2021-11-21;2622;3484;10643;17;52223514;50762480;5700133;4569;77.8;75.6;8.5;0.0
FR;2021-11-22;22731;19164;194737;85;52246245;50781644;5894870;4654;77.8;75.7;8.8;0.0
FR;2021-11-23;25544;24457;247701;82;52271789;50806101;6142571;4736;77.9;75.7;9.2;0.0
FR;2021-11-24;31760;34771;243107;80;52303549;50840872;6385678;4816;77.9;75.8;9.5;0.0
FR;2021-11-25;25381;25191;277583;110;52328930;50866063;6663261;4926;78.0;75.8;9.9;0.0
FR;2021-11-26;33201;37581;414491;160;52362131;50903644;7077752;5086;78.0;75.8;10.5;0.0
FR;2021-11-27;23292;28652;236547;150;52385423;50932296;7314299;5236;78.1;75.9;10.9;0.0
FR;2021-11-28;3478;4127;63329;41;52388901;50936423;7377628;5277;78.1;75.9;11.0;0.0
FR;2021-11-29;19384;23454;371537;175;52408285;50959877;7749165;5452;78.1;75.9;11.5;0.0
FR;2021-11-30;24675;27272;500626;281;52432960;50987149;8249791;5733;78.1;76.0;12.3;0.0
FR;2021-12-01;26825;31866;511170;300;52459785;51019015;8760961;6033;78.2;76.0;13.1;0.0
FR;2021-12-02;21966;21378;574686;302;52481751;51040393;9335647;6335;78.2;76.0;13.9;0.0
FR;2021-12-03;25459;34149;650957;325;52507210;51074542;9986604;6660;78.2;76.1;14.9;0.0
FR;2021-12-04;18285;25911;369685;216;52525495;51100453;10356289;6876;78.3;76.1;15.4;0.0
FR;2021-12-05;4141;4961;107048;94;52529636;51105414;10463337;6970;78.3;76.1;15.6;0.0
FR;2021-12-06;22523;25746;539812;383;52552159;51131160;11003149;7353;78.3;76.2;16.4;0.0
FR;2021-12-07;23303;29177;706135;407;52575462;51160337;11709284;7760;78.3;76.2;17.4;0.0
FR;2021-12-08;25325;35421;647307;436;52600787;51195758;12356591;8196;78.4;76.3;18.4;0.0
FR;2021-12-09;23990;29485;726167;454;52624777;51225243;13082758;8650;78.4;76.3;19.5;0.0
FR;2021-12-10;27638;38313;805973;461;52652415;51263556;13888731;9111;78.5;76.4;20.7;0.0
FR;2021-12-11;20219;29943;480316;353;52672634;51293499;14369047;9464;78.5;76.4;21.4;0.0
FR;2021-12-12;5624;6464;159225;107;52678258;51299963;14528272;9571;78.5;76.4;21.6;0.0
FR;2021-12-13;21047;30165;649185;393;52699305;51330128;15177457;9964;78.5;76.5;22.6;0.0
FR;2021-12-14;27537;35827;847349;681;52726842;51365955;16024806;10645;78.6;76.5;23.9;0.0
FR;2021-12-15;28181;39897;768901;490;52755023;51405852;16793707;11135;78.6;76.6;25.0;0.0
FR;2021-12-16;27926;35604;844256;504;52782949;51441456;17637963;11639;78.6;76.6;26.3;0.0
FR;2021-12-17;31534;43768;891979;592;52814483;51485224;18529942;12231;78.7;76.7;27.6;0.0
FR;2021-12-18;24913;30229;522139;365;52839396;51515453;19052081;12596;78.7;76.8;28.4;0.0
FR;2021-12-19;8740;7962;191144;141;52848136;51523415;19243225;12737;78.7;76.8;28.7;0.0
FR;2021-12-20;31584;34242;658580;488;52879720;51557657;19901805;13225;78.8;76.8;29.7;0.0
FR;2021-12-21;39212;39212;759447;578;52918932;51596869;20661252;13803;78.8;76.9;30.8;0.0
FR;2021-12-22;39456;37470;642023;702;52958388;51634339;21303275;14505;78.9;76.9;31.7;0.0
FR;2021-12-23;33737;30369;494320;592;52992125;51664708;21797595;15097;79.0;77.0;32.5;0.0
FR;2021-12-24;10663;11612;126628;239;53002788;51676320;21924223;15336;79.0;77.0;32.7;0.0
FR;2021-12-25;767;1938;9028;72;53003555;51678258;21933251;15408;79.0;77.0;32.7;0.0
FR;2021-12-26;4696;4763;60130;169;53008251;51683021;21993381;15577;79.0;77.0;32.8;0.0
FR;2021-12-27;30347;33161;509081;673;53038598;51716182;22502462;16250;79.0;77.1;33.5;0.0
FR;2021-12-28;38304;35302;632145;1556;53076902;51751484;23134607;17806;79.1;77.1;34.5;0.0
FR;2021-12-29;39840;33266;560919;1752;53116742;51784750;23695526;19558;79.1;77.2;35.3;0.0
FR;2021-12-30;35885;29377;471082;1881;53152627;51814127;24166608;21439;79.2;77.2;36.0;0.0
FR;2021-12-31;12032;11341;131620;755;53164659;51825468;24298228;22194;79.2;77.2;36.2;0.0
FR;2022-01-01;1310;1764;9926;100;53165969;51827232;24308154;22294;79.2;77.2;36.2;0.0
FR;2022-01-02;6074;5087;66930;408;53172043;51832319;24375084;22702;79.2;77.2;36.3;0.0
FR;2022-01-03;32562;36554;551467;2642;53204605;51868873;24926551;25344;79.3;77.3;37.1;0.0
FR;2022-01-04;40836;40487;714199;3839;53245441;51909360;25640750;29183;79.3;77.3;38.2;0.0
FR;2022-01-05;60299;43346;634049;3436;53305740;51952706;26274799;32619;79.4;77.4;39.1;0.0
FR;2022-01-06;43917;40043;711308;4564;53349657;51992749;26986107;37183;79.5;77.5;40.2;0.1
FR;2022-01-07;50542;46568;790319;5003;53400199;52039317;27776426;42186;79.6;77.5;41.4;0.1
FR;2022-01-08;44950;35002;472837;2443;53445149;52074319;28249263;44629;79.6;77.6;42.1;0.1
FR;2022-01-09;15597;11489;145699;830;53460746;52085808;28394962;45459;79.7;77.6;42.3;0.1
FR;2022-01-10;34980;38248;522147;3718;53495726;52124056;28917109;49177;79.7;77.7;43.1;0.1
FR;2022-01-11;41635;41973;608383;5218;53537361;52166029;29525492;54395;79.8;77.7;44.0;0.1
FR;2022-01-12;60129;49182;504229;4492;53597490;52215211;30029721;58887;79.9;77.8;44.7;0.1
FR;2022-01-13;37887;40257;540919;5462;53635377;52255468;30570640;64349;79.9;77.9;45.5;0.1
FR;2022-01-14;42373;43332;628950;6460;53677750;52298800;31199590;70809;80.0;77.9;46.5;0.1
FR;2022-01-15;39300;31259;377533;3289;53717050;52330059;31577123;74098;80.0;78.0;47.0;0.1
FR;2022-01-16;11381;9007;99448;760;53728431;52339066;31676571;74858;80.1;78.0;47.2;0.1
FR;2022-01-17;24591;28013;354136;3961;53753022;52367079;32030707;78819;80.1;78.0;47.7;0.1
FR;2022-01-18;28101;31712;397501;5774;53781123;52398791;32428208;84593;80.1;78.1;48.3;0.1
FR;2022-01-19;43033;40246;311039;4386;53824156;52439037;32739247;88979;80.2;78.1;48.8;0.1
FR;2022-01-20;23403;29299;328398;5627;53847559;52468336;33067645;94606;80.2;78.2;49.3;0.1
FR;2022-01-21;27984;32960;401114;6581;53875543;52501296;33468759;101187;80.3;78.2;49.9;0.2
FR;2022-01-22;27605;27146;241742;2842;53903148;52528442;33710501;104029;80.3;78.3;50.2;0.2
FR;2022-01-23;6701;7512;55182;589;53909849;52535954;33765683;104618;80.3;78.3;50.3;0.2
FR;2022-01-24;16193;25036;239314;4095;53926042;52560990;34004997;108713;80.3;78.3;50.7;0.2
FR;2022-01-25;18897;28529;267026;6066;53944939;52589519;34272023;114779;80.4;78.4;51.1;0.2
FR;2022-01-26;28103;41013;229338;4474;53973042;52630532;34501361;119253;80.4;78.4;51.4;0.2
FR;2022-01-27;16271;25652;225803;5692;53989313;52656184;34727164;124945;80.4;78.5;51.7;0.2
FR;2022-01-28;21497;41801;321455;7409;54010810;52697985;35048619;132354;80.5;78.5;52.2;0.2
FR;2022-01-29;18401;32668;204566;3249;54029211;52730653;35253185;135603;80.5;78.6;52.5;0.2
FR;2022-01-30;4466;9158;45092;639;54033677;52739811;35298277;136242;80.5;78.6;52.6;0.2
FR;2022-01-31;11219;25959;164781;4243;54044896;52765770;35463058;140485;80.5;78.6;52.8;0.2
FR;2022-02-01;12794;27086;191355;7099;54057690;52792856;35654413;147584;80.5;78.7;53.1;0.2
FR;2022-02-02;19971;45628;190117;5992;54077661;52838484;35844530;153576;80.6;78.7;53.4;0.2
FR;2022-02-03;10937;24609;173293;6968;54088598;52863093;36017823;160544;80.6;78.8;53.7;0.2
FR;2022-02-04;14474;35924;264164;9207;54103072;52899017;36281987;169751;80.6;78.8;54.1;0.3
FR;2022-02-05;12781;31933;172331;3816;54115853;52930950;36454318;173567;80.6;78.9;54.3;0.3
FR;2022-02-06;2706;7327;33828;663;54118559;52938277;36488146;174230;80.6;78.9;54.4;0.3
FR;2022-02-07;9280;24410;176314;5288;54127839;52962687;36664460;179518;80.6;78.9;54.6;0.3
FR;2022-02-08;9587;20512;184318;7049;54137426;52983199;36848778;186567;80.7;78.9;54.9;0.3
FR;2022-02-09;14148;34906;192950;5775;54151574;53018105;37041728;192342;80.7;79.0;55.2;0.3
FR;2022-02-10;8259;17839;166568;6494;54159833;53035944;37208296;198836;80.7;79.0;55.4;0.3
FR;2022-02-11;10741;25594;242996;8324;54170574;53061538;37451292;207160;80.7;79.1;55.8;0.3
FR;2022-02-12;8344;22547;151703;3502;54178918;53084085;37602995;210662;80.7;79.1;56.0;0.3
FR;2022-02-13;1892;4388;30902;540;54180810;53088473;37633897;211202;80.7;79.1;56.1;0.3
FR;2022-02-14;6887;14497;166300;4774;54187697;53102970;37800197;215976;80.7;79.1;56.3;0.3
FR;2022-02-15;6848;15228;162428;6846;54194545;53118198;37962625;222822;80.7;79.1;56.6;0.3
FR;2022-02-16;9282;25571;146642;5720;54203827;53143769;38109267;228542;80.8;79.2;56.8;0.3
FR;2022-02-17;5364;12536;94753;5403;54209191;53156305;38204020;233945;80.8;79.2;56.9;0.3
FR;2022-02-18;6874;18409;129235;7400;54216065;53174714;38333255;241345;80.8;79.2;57.1;0.4
FR;2022-02-19;5340;15801;77300;3016;54221405;53190515;38410555;244361;80.8;79.3;57.2;0.4
FR;2022-02-20;1135;2882;13923;459;54222540;53193397;38424478;244820;80.8;79.3;57.3;0.4
FR;2022-02-21;4018;10032;67134;4058;54226558;53203429;38491612;248878;80.8;79.3;57.4;0.4
FR;2022-02-22;4365;11089;64404;5249;54230923;53214518;38556016;254127;80.8;79.3;57.4;0.4
FR;2022-02-23;6507;19380;71852;4590;54237430;53233898;38627868;258717;80.8;79.3;57.6;0.4
FR;2022-02-24;3743;9110;53172;4530;54241173;53243008;38681040;263247;80.8;79.3;57.6;0.4
FR;2022-02-25;5194;14520;79994;7327;54246367;53257528;38761034;270574;80.8;79.4;57.8;0.4
FR;2022-02-26;3969;12032;51450;3083;54250336;53269560;38812484;273657;80.8;79.4;57.8;0.4
FR;2022-02-27;867;1954;8931;529;54251203;53271514;38821415;274186;80.8;79.4;57.8;0.4
FR;2022-02-28;3066;7154;42869;3847;54254269;53278668;38864284;278033;80.8;79.4;57.9;0.4
FR;2022-03-01;3120;7261;44757;5508;54257389;53285929;38909041;283541;80.8;79.4;58.0;0.4
FR;2022-03-02;5067;12498;48983;4919;54262456;53298427;38958024;288460;80.8;79.4;58.0;0.4
FR;2022-03-03;2644;5773;29918;4042;54265100;53304200;38987942;292502;80.9;79.4;58.1;0.4
FR;2022-03-04;3175;8171;39382;6208;54268275;53312371;39027324;298710;80.9;79.4;58.1;0.4
FR;2022-03-05;2915;7057;25071;3130;54271190;53319428;39052395;301840;80.9;79.4;58.2;0.4
FR;2022-03-06;508;1008;3429;378;54271698;53320436;39055824;302218;80.9;79.4;58.2;0.5
FR;2022-03-07;1932;3688;17648;3298;54273630;53324124;39073472;305516;80.9;79.5;58.2;0.5
FR;2022-03-08;1962;4143;17856;4088;54275592;53328267;39091328;309604;80.9;79.5;58.2;0.5
FR;2022-03-09;3445;8495;21220;4029;54279037;53336762;39112548;313633;80.9;79.5;58.3;0.5
FR;2022-03-10;1706;3743;15672;3392;54280743;53340505;39128220;317025;80.9;79.5;58.3;0.5
FR;2022-03-11;2340;5167;22217;5468;54283083;53345672;39150437;322493;80.9;79.5;58.3;0.5
FR;2022-03-12;2654;5424;16497;3132;54285737;53351096;39166934;325625;80.9;79.5;58.4;0.5
FR;2022-03-13;385;589;2252;529;54286122;53351685;39169186;326154;80.9;79.5;58.4;0.5
FR;2022-03-14;1457;2657;13782;7277;54287579;53354342;39182968;333431;80.9;79.5;58.4;0.5
FR;2022-03-15;1591;2993;14329;11012;54289170;53357335;39197297;344443;80.9;79.5;58.4;0.5
FR;2022-03-16;2939;5830;17999;16285;54292109;53363165;39215296;360728;80.9;79.5;58.4;0.5
FR;2022-03-17;1367;2487;11928;13293;54293476;53365652;39227224;374021;80.9;79.5;58.4;0.6
FR;2022-03-18;2195;3844;18014;22007;54295671;53369496;39245238;396028;80.9;79.5;58.5;0.6
FR;2022-03-19;2274;3996;12399;11402;54297945;53373492;39257637;407430;80.9;79.5;58.5;0.6
FR;2022-03-20;291;501;1914;1332;54298236;53373993;39259551;408762;80.9;79.5;58.5;0.6
FR;2022-03-21;1337;2053;11902;16896;54299573;53376046;39271453;425658;80.9;79.5;58.5;0.6
FR;2022-03-22;1455;2408;12505;22809;54301028;53378454;39283958;448467;80.9;79.5;58.5;0.7
FR;2022-03-23;2631;4997;17134;25240;54303659;53383451;39301092;473707;80.9;79.5;58.6;0.7
FR;2022-03-24;1352;2006;10609;19350;54305011;53385457;39311701;493057;80.9;79.5;58.6;0.7
FR;2022-03-25;2039;3325;16805;30770;54307050;53388782;39328506;523827;80.9;79.5;58.6;0.8
FR;2022-03-26;2214;3687;11494;14373;54309264;53392469;39340000;538200;80.9;79.6;58.6;0.8
FR;2022-03-27;352;499;1907;1730;54309616;53392968;39341907;539930;80.9;79.6;58.6;0.8
FR;2022-03-28;1409;1948;10532;19024;54311025;53394916;39352439;558954;80.9;79.6;58.6;0.8
FR;2022-03-29;1419;2021;11989;29230;54312444;53396937;39364428;588184;80.9;79.6;58.7;0.9
FR;2022-03-30;2805;4541;14981;29250;54315249;53401478;39379409;617434;80.9;79.6;58.7;0.9
FR;2022-03-31;1584;2104;12133;26470;54316833;53403582;39391542;643904;80.9;79.6;58.7;1.0
FR;2022-04-01;2070;2641;18584;33401;54318903;53406223;39410126;677305;80.9;79.6;58.7;1.0
FR;2022-04-02;1489;1965;8673;11266;54320392;53408188;39418799;688571;80.9;79.6;58.7;1.0
FR;2022-04-03;270;337;1570;1378;54320662;53408525;39420369;689949;80.9;79.6;58.7;1.0
FR;2022-04-04;1307;1544;11278;20496;54321969;53410069;39431647;710445;80.9;79.6;58.8;1.1
FR;2022-04-05;1578;1786;13057;35579;54323547;53411855;39444704;746024;80.9;79.6;58.8;1.1
FR;2022-04-06;2020;2675;12627;27770;54325567;53414530;39457331;773794;80.9;79.6;58.8;1.2
FR;2022-04-07;1415;1684;12764;34890;54326982;53416214;39470095;808684;80.9;79.6;58.8;1.2
FR;2022-04-08;2004;2385;17706;45923;54328986;53418599;39487801;854607;80.9;79.6;58.8;1.3
FR;2022-04-09;1340;1869;8831;14766;54330326;53420468;39496632;869373;81.0;79.6;58.8;1.3
FR;2022-04-10;271;361;1968;2252;54330597;53420829;39498600;871625;81.0;79.6;58.9;1.3
FR;2022-04-11;1170;1459;11393;24894;54331767;53422288;39509993;896519;81.0;79.6;58.9;1.3
FR;2022-04-12;1555;1648;13224;41364;54333322;53423936;39523217;937883;81.0;79.6;58.9;1.4
FR;2022-04-13;1830;2393;12839;33658;54335152;53426329;39536056;971541;81.0;79.6;58.9;1.4
FR;2022-04-14;1423;1582;12832;36536;54336575;53427911;39548888;1008077;81.0;79.6;58.9;1.5
FR;2022-04-15;1755;2039;14691;36819;54338330;53429950;39563579;1044896;81.0;79.6;58.9;1.6
FR;2022-04-16;1023;1229;6203;9400;54339353;53431179;39569782;1054296;81.0;79.6;59.0;1.6
FR;2022-04-17;183;198;1026;1223;54339536;53431377;39570808;1055519;81.0;79.6;59.0;1.6
FR;2022-04-18;142;229;2733;1247;54339678;53431606;39573541;1056766;81.0;79.6;59.0;1.6
FR;2022-04-19;1458;1736;12263;30378;54341136;53433342;39585804;1087144;81.0;79.6;59.0;1.6
FR;2022-04-20;1877;2402;12765;29636;54343013;53435744;39598569;1116780;81.0;79.6;59.0;1.7
FR;2022-04-21;1463;1672;12399;35216;54344476;53437416;39610968;1151996;81.0;79.6;59.0;1.7
FR;2022-04-22;1805;2203;15712;38827;54346281;53439619;39626680;1190823;81.0;79.6;59.0;1.8
FR;2022-04-23;1102;1433;7190;11408;54347383;53441052;39633870;1202231;81.0;79.6;59.1;1.8
FR;2022-04-24;232;300;1396;1827;54347615;53441352;39635266;1204058;81.0;79.6;59.1;1.8
FR;2022-04-25;1233;1483;10370;21790;54348848;53442835;39645636;1225848;81.0;79.6;59.1;1.8
FR;2022-04-26;1539;1857;12965;38898;54350387;53444692;39658601;1264746;81.0;79.6;59.1;1.9
FR;2022-04-27;1876;2183;11419;30866;54352263;53446875;39670020;1295612;81.0;79.6;59.1;1.9
FR;2022-04-28;1505;1684;12068;35901;54353768;53448559;39682088;1331513;81.0;79.6;59.1;2.0
FR;2022-04-29;1926;2186;14644;38188;54355694;53450745;39696732;1369701;81.0;79.6;59.1;2.0
FR;2022-04-30;1171;1253;6555;10515;54356865;53451998;39703287;1380216;81.0;79.6;59.2;2.1
FR;2022-05-01;166;196;857;1081;54357031;53452194;39704144;1381297;81.0;79.6;59.2;2.1
FR;2022-05-02;1118;1221;10041;18498;54358149;53453415;39714185;1399795;81.0;79.6;59.2;2.1
FR;2022-05-03;1696;1688;12866;34830;54359845;53455103;39727051;1434625;81.0;79.6;59.2;2.1
FR;2022-05-04;1775;1864;11042;25533;54361620;53456967;39738093;1460158;81.0;79.6;59.2;2.2
FR;2022-05-05;1573;1597;11389;33379;54363193;53458564;39749482;1493537;81.0;79.7;59.2;2.2
FR;2022-05-06;2011;2108;14149;37731;54365204;53460672;39763631;1531268;81.0;79.7;59.2;2.3
FR;2022-05-07;1151;1201;6099;10232;54366355;53461873;39769730;1541500;81.0;79.7;59.3;2.3
FR;2022-05-08;247;249;1082;1607;54366602;53462122;39770812;1543107;81.0;79.7;59.3;2.3
FR;2022-05-09;1200;1151;8487;20570;54367802;53463273;39779299;1563677;81.0;79.7;59.3;2.3
FR;2022-05-10;1589;1645;11695;38882;54369391;53464918;39790994;1602559;81.0;79.7;59.3;2.4
FR;2022-05-11;1886;1937;9677;27658;54371277;53466855;39800671;1630217;81.0;79.7;59.3;2.4
FR;2022-05-12;1476;1507;10207;35458;54372753;53468362;39810878;1665675;81.0;79.7;59.3;2.5
FR;2022-05-13;1878;1834;12415;38046;54374631;53470196;39823293;1703721;81.0;79.7;59.3;2.5
FR;2022-05-14;1101;1084;5256;11134;54375732;53471280;39828549;1714855;81.0;79.7;59.3;2.6
FR;2022-05-15;254;210;1184;1521;54375986;53471490;39829733;1716376;81.0;79.7;59.3;2.6
FR;2022-05-16;1098;1017;7150;20507;54377084;53472507;39836883;1736883;81.0;79.7;59.4;2.6
FR;2022-05-17;1475;1429;9874;36933;54378559;53473936;39846757;1773816;81.0;79.7;59.4;2.6
FR;2022-05-18;1662;1683;8180;26085;54380221;53475619;39854937;1799901;81.0;79.7;59.4;2.7
FR;2022-05-19;1280;1324;8817;32736;54381501;53476943;39863754;1832637;81.0;79.7;59.4;2.7
