fra;jour;n_dose1;n_complet;n_rappel;n_2_rappel;n_cum_dose1;n_cum_complet;n_cum_rappel;n_cum_2_rappel;couv_dose1;couv_complet;couv_rappel;couv_2_rappel
FR;2020-12-27;602;55;0;0;602;55;0;0;0.0;0.0;0.0;0.0
FR;2020-12-28;666;42;0;0;1268;97;0;0;0.0;0.0;0.0;0.0
FR;2020-12-29;373;19;0;0;1641;116;0;0;0.0;0.0;0.0;0.0
FR;2020-12-30;439;18;0;0;2080;134;0;0;0.0;0.0;0.0;0.0
FR;2020-12-31;422;22;0;0;2502;156;0;0;0.0;0.0;0.0;0.0
FR;2021-01-01;1135;65;0;0;3637;221;0;0;0.0;0.0;0.0;0.0
FR;2021-01-02;356;30;0;0;3993;251;0;0;0.0;0.0;0.0;0.0
FR;2021-01-03;401;27;0;0;4394;278;0;0;0.0;0.0;0.0;0.0
FR;2021-01-04;2088;48;0;0;6482;326;0;0;0.0;0.0;0.0;0.0
FR;2021-01-05;7581;124;0;0;14063;450;0;0;0.0;0.0;0.0;0.0
FR;2021-01-06;12416;120;0;0;26479;570;0;0;0.0;0.0;0.0;0.0
FR;2021-01-07;29446;157;0;0;55925;727;0;0;0.1;0.0;0.0;0.0
FR;2021-01-08;37120;195;0;0;93045;922;0;0;0.1;0.0;0.0;0.0
FR;2021-01-09;11209;75;0;0;104254;997;0;0;0.2;0.0;0.0;0.0
FR;2021-01-10;5996;24;0;0;110250;1021;0;0;0.2;0.0;0.0;0.0
FR;2021-01-11;39924;225;0;0;150174;1246;0;0;0.2;0.0;0.0;0.0
FR;2021-01-12;62121;310;0;0;212295;1556;0;0;0.3;0.0;0.0;0.0
FR;2021-01-13;65097;429;0;0;277392;1985;0;0;0.4;0.0;0.0;0.0
FR;2021-01-14;83122;1189;0;0;360514;3174;0;0;0.5;0.0;0.0;0.0
FR;2021-01-15;68988;560;0;0;429502;3734;0;0;0.6;0.0;0.0;0.0
FR;2021-01-16;20208;187;0;0;449710;3921;0;0;0.7;0.0;0.0;0.0
FR;2021-01-17;10976;130;0;0;460686;4051;0;0;0.7;0.0;0.0;0.0
FR;2021-01-18;85880;612;0;0;546566;4663;0;0;0.8;0.0;0.0;0.0
FR;2021-01-19;130572;865;0;0;677138;5528;0;0;1.0;0.0;0.0;0.0
FR;2021-01-20;137525;852;0;0;814663;6380;0;0;1.2;0.0;0.0;0.0
FR;2021-01-21;158375;968;0;0;973038;7348;0;0;1.4;0.0;0.0;0.0
FR;2021-01-22;121039;833;0;0;1094077;8181;0;0;1.6;0.0;0.0;0.0
FR;2021-01-23;38465;203;0;0;1132542;8384;0;0;1.7;0.0;0.0;0.0
FR;2021-01-24;9740;134;0;0;1142282;8518;0;0;1.7;0.0;0.0;0.0
FR;2021-01-25;78221;1630;0;0;1220503;10148;0;0;1.8;0.0;0.0;0.0
FR;2021-01-26;100361;3763;0;0;1320864;13911;0;0;2.0;0.0;0.0;0.0
FR;2021-01-27;107223;6650;0;0;1428087;20561;0;0;2.1;0.0;0.0;0.0
FR;2021-01-28;124328;15806;0;0;1552415;36367;0;0;2.3;0.1;0.0;0.0
FR;2021-01-29;92170;18280;0;0;1644585;54647;0;0;2.5;0.1;0.0;0.0
FR;2021-01-30;29113;4371;0;0;1673698;59018;0;0;2.5;0.1;0.0;0.0
FR;2021-01-31;5225;1770;0;0;1678923;60788;0;0;2.5;0.1;0.0;0.0
FR;2021-02-01;53103;21756;0;0;1732026;82544;0;0;2.6;0.1;0.0;0.0
FR;2021-02-02;72275;36131;0;0;1804301;118675;0;0;2.7;0.2;0.0;0.0
FR;2021-02-03;72289;38436;0;0;1876590;157111;0;0;2.8;0.2;0.0;0.0
FR;2021-02-04;82049;52028;0;0;1958639;209139;0;0;2.9;0.3;0.0;0.0
FR;2021-02-05;68215;46497;0;0;2026854;255636;0;0;3.0;0.4;0.0;0.0
FR;2021-02-06;23109;10969;0;0;2049963;266605;0;0;3.1;0.4;0.0;0.0
FR;2021-02-07;5182;5379;0;0;2055145;271984;0;0;3.1;0.4;0.0;0.0
FR;2021-02-08;46815;47271;0;0;2101960;319255;0;0;3.1;0.5;0.0;0.0
FR;2021-02-09;65990;75403;0;0;2167950;394658;0;0;3.2;0.6;0.0;0.0
FR;2021-02-10;70985;80466;0;0;2238935;475124;0;0;3.3;0.7;0.0;0.0
FR;2021-02-11;87238;102834;0;0;2326173;577958;0;0;3.5;0.9;0.0;0.0
FR;2021-02-12;79289;76501;0;0;2405462;654459;0;0;3.6;1.0;0.0;0.0
FR;2021-02-13;22353;19785;0;0;2427815;674244;0;0;3.6;1.0;0.0;0.0
FR;2021-02-14;5071;7300;0;0;2432886;681544;0;0;3.6;1.0;0.0;0.0
FR;2021-02-15;38068;77408;0;0;2470954;758952;0;0;3.7;1.1;0.0;0.0
FR;2021-02-16;50362;101683;0;0;2521316;860635;0;0;3.8;1.3;0.0;0.0
FR;2021-02-17;50500;105813;0;0;2571816;966448;0;0;3.8;1.4;0.0;0.0
FR;2021-02-18;69756;122208;0;0;2641572;1088656;0;0;3.9;1.6;0.0;0.0
FR;2021-02-19;65048;92699;0;0;2706620;1181355;0;0;4.0;1.8;0.0;0.0
FR;2021-02-20;18574;28854;0;0;2725194;1210209;0;0;4.1;1.8;0.0;0.0
FR;2021-02-21;3314;6401;0;0;2728508;1216610;0;0;4.1;1.8;0.0;0.0
FR;2021-02-22;37476;73971;0;0;2765984;1290581;0;0;4.1;1.9;0.0;0.0
FR;2021-02-23;53760;85824;0;0;2819744;1376405;0;0;4.2;2.1;0.0;0.0
FR;2021-02-24;59981;83166;0;0;2879725;1459571;0;0;4.3;2.2;0.0;0.0
FR;2021-02-25;100542;94264;0;0;2980267;1553835;0;0;4.4;2.3;0.0;0.0
FR;2021-02-26;113432;73719;0;0;3093699;1627554;0;0;4.6;2.4;0.0;0.0
FR;2021-02-27;52091;23352;0;0;3145790;1650906;0;0;4.7;2.5;0.0;0.0
FR;2021-02-28;6191;4480;0;0;3151981;1655386;0;0;4.7;2.5;0.0;0.0
FR;2021-03-01;65832;55073;0;0;3217813;1710459;0;0;4.8;2.5;0.0;0.0
FR;2021-03-02;101345;69514;0;0;3319158;1779973;0;0;4.9;2.7;0.0;0.0
FR;2021-03-03;116465;69095;0;0;3435623;1849068;0;0;5.1;2.8;0.0;0.0
FR;2021-03-04;163584;75713;0;0;3599207;1924781;0;0;5.4;2.9;0.0;0.0
FR;2021-03-05;200883;69766;0;0;3800090;1994547;0;0;5.7;3.0;0.0;0.0
FR;2021-03-06;207925;23024;0;0;4008015;2017571;0;0;6.0;3.0;0.0;0.0
FR;2021-03-07;121250;8283;0;0;4129265;2025854;0;0;6.2;3.0;0.0;0.0
FR;2021-03-08;107111;53768;0;0;4236376;2079622;0;0;6.3;3.1;0.0;0.0
FR;2021-03-09;172410;61894;0;0;4408786;2141516;0;0;6.6;3.2;0.0;0.0
FR;2021-03-10;178937;62715;0;0;4587723;2204231;0;0;6.8;3.3;0.0;0.0
FR;2021-03-11;242825;71476;0;0;4830548;2275707;0;0;7.2;3.4;0.0;0.0
FR;2021-03-12;294775;62783;0;0;5125323;2338490;0;0;7.6;3.5;0.0;0.0
FR;2021-03-13;231370;21313;0;0;5356693;2359803;0;0;8.0;3.5;0.0;0.0
FR;2021-03-14;63336;5329;0;0;5420029;2365132;0;0;8.1;3.5;0.0;0.0
FR;2021-03-15;158601;36778;0;0;5578630;2401910;0;0;8.3;3.6;0.0;0.0
FR;2021-03-16;141539;43213;0;0;5720169;2445123;0;0;8.5;3.6;0.0;0.0
FR;2021-03-17;150447;42924;0;0;5870616;2488047;0;0;8.7;3.7;0.0;0.0
FR;2021-03-18;167782;50019;0;0;6038398;2538066;0;0;9.0;3.8;0.0;0.0
FR;2021-03-19;229962;44510;0;0;6268360;2582576;0;0;9.3;3.8;0.0;0.0
FR;2021-03-20;166641;16203;0;0;6435001;2598779;0;0;9.6;3.9;0.0;0.0
FR;2021-03-21;49920;4268;0;0;6484921;2603047;0;0;9.7;3.9;0.0;0.0
FR;2021-03-22;169994;39441;0;0;6654915;2642488;0;0;9.9;3.9;0.0;0.0
FR;2021-03-23;250329;50149;0;0;6905244;2692637;0;0;10.3;4.0;0.0;0.0
FR;2021-03-24;256848;51733;0;0;7162092;2744370;0;0;10.7;4.1;0.0;0.0
FR;2021-03-25;341747;55800;0;0;7503839;2800170;0;0;11.2;4.2;0.0;0.0
FR;2021-03-26;358747;53610;0;0;7862586;2853780;0;0;11.7;4.3;0.0;0.0
FR;2021-03-27;195240;23150;0;0;8057826;2876930;0;0;12.0;4.3;0.0;0.0
FR;2021-03-28;59321;6069;0;0;8117147;2882999;0;0;12.1;4.3;0.0;0.0
FR;2021-03-29;202929;60684;0;0;8320076;2943683;0;0;12.4;4.4;0.0;0.0
FR;2021-03-30;285405;79974;0;0;8605481;3023657;0;0;12.8;4.5;0.0;0.0
FR;2021-03-31;262961;83834;0;0;8868442;3107491;0;0;13.2;4.6;0.0;0.0
FR;2021-04-01;315382;102728;0;0;9183824;3210219;0;0;13.7;4.8;0.0;0.0
FR;2021-04-02;281279;104506;0;0;9465103;3314725;0;0;14.1;4.9;0.0;0.0
FR;2021-04-03;141049;67140;0;0;9606152;3381865;0;0;14.3;5.0;0.0;0.0
FR;2021-04-04;46456;20775;0;0;9652608;3402640;0;0;14.4;5.1;0.0;0.0
FR;2021-04-05;63306;13448;0;0;9715914;3416088;0;0;14.5;5.1;0.0;0.0
FR;2021-04-06;217144;117952;0;0;9933058;3534040;0;0;14.8;5.3;0.0;0.0
FR;2021-04-07;260188;126622;0;0;10193246;3660662;0;0;15.2;5.5;0.0;0.0
FR;2021-04-08;337734;137209;0;0;10530980;3797871;0;0;15.7;5.7;0.0;0.0
FR;2021-04-09;410082;133608;0;0;10941062;3931479;0;0;16.3;5.9;0.0;0.0
FR;2021-04-10;212582;90947;0;0;11153644;4022426;0;0;16.6;6.0;0.0;0.0
FR;2021-04-11;56123;36940;0;0;11209767;4059366;0;0;16.7;6.0;0.0;0.0
FR;2021-04-12;236999;124732;0;0;11446766;4184098;0;0;17.1;6.2;0.0;0.0
FR;2021-04-13;309416;157342;0;0;11756182;4341440;0;0;17.5;6.5;0.0;0.0
FR;2021-04-14;294432;152567;0;0;12050614;4494007;0;0;18.0;6.7;0.0;0.0
FR;2021-04-15;337008;163799;0;0;12387622;4657806;0;0;18.5;6.9;0.0;0.0
FR;2021-04-16;339225;160457;0;0;12726847;4818263;0;0;19.0;7.2;0.0;0.0
FR;2021-04-17;188622;97658;0;0;12915469;4915921;0;0;19.2;7.3;0.0;0.0
FR;2021-04-18;51603;37767;0;0;12967072;4953688;0;0;19.3;7.4;0.0;0.0
FR;2021-04-19;205640;147259;0;0;13172712;5100947;0;0;19.6;7.6;0.0;0.0
FR;2021-04-20;254345;182395;0;0;13427057;5283342;0;0;20.0;7.9;0.0;0.0
FR;2021-04-21;253179;181016;0;0;13680236;5464358;0;0;20.4;8.1;0.0;0.0
FR;2021-04-22;287490;203223;0;0;13967726;5667581;0;0;20.8;8.4;0.0;0.0
FR;2021-04-23;297928;202436;0;0;14265654;5870017;0;0;21.3;8.7;0.0;0.0
FR;2021-04-24;190409;121948;0;0;14456063;5991965;0;0;21.5;8.9;0.0;0.0
FR;2021-04-25;69539;42497;0;0;14525602;6034462;0;0;21.6;9.0;0.0;0.0
FR;2021-04-26;220890;169398;0;0;14746492;6203860;0;0;22.0;9.2;0.0;0.0
FR;2021-04-27;284545;210569;0;0;15031037;6414429;0;0;22.4;9.6;0.0;0.0
FR;2021-04-28;299441;208260;1;0;15330478;6622689;1;0;22.8;9.9;0.0;0.0
FR;2021-04-29;357055;231532;0;0;15687533;6854221;1;0;23.4;10.2;0.0;0.0
FR;2021-04-30;372133;224096;0;0;16059666;7078317;1;0;23.9;10.5;0.0;0.0
FR;2021-05-01;167598;63722;0;0;16227264;7142039;1;0;24.2;10.6;0.0;0.0
FR;2021-05-02;91707;43452;0;0;16318971;7185491;1;0;24.3;10.7;0.0;0.0
FR;2021-05-03;288853;188871;0;0;16607824;7374362;1;0;24.7;11.0;0.0;0.0
FR;2021-05-04;315594;250460;0;0;16923418;7624822;1;0;25.2;11.4;0.0;0.0
FR;2021-05-05;327098;249719;0;0;17250516;7874541;1;0;25.7;11.7;0.0;0.0
FR;2021-05-06;379421;273594;0;0;17629937;8148135;1;0;26.3;12.1;0.0;0.0
FR;2021-05-07;372678;298267;0;0;18002615;8446402;1;0;26.8;12.6;0.0;0.0
FR;2021-05-08;222134;82573;0;0;18224749;8528975;1;0;27.2;12.7;0.0;0.0
FR;2021-05-09;129684;55007;0;0;18354433;8583982;1;0;27.3;12.8;0.0;0.0
FR;2021-05-10;313296;254409;0;0;18667729;8838391;1;0;27.8;13.2;0.0;0.0
FR;2021-05-11;403815;296180;0;0;19071544;9134571;1;0;28.4;13.6;0.0;0.0
FR;2021-05-12;434027;269258;0;0;19505571;9403829;1;0;29.1;14.0;0.0;0.0
FR;2021-05-13;338548;78404;0;0;19844119;9482233;1;0;29.6;14.1;0.0;0.0
FR;2021-05-14;454052;202755;0;0;20298171;9684988;1;0;30.2;14.4;0.0;0.0
FR;2021-05-15;374922;120385;0;0;20673093;9805373;1;0;30.8;14.6;0.0;0.0
FR;2021-05-16;202722;34171;0;0;20875815;9839544;1;0;31.1;14.7;0.0;0.0
FR;2021-05-17;376064;178535;0;0;21251879;10018079;1;0;31.7;14.9;0.0;0.0
FR;2021-05-18;460057;192216;0;0;21711936;10210295;1;0;32.4;15.2;0.0;0.0
FR;2021-05-19;467319;181973;0;0;22179255;10392268;1;0;33.0;15.5;0.0;0.0
FR;2021-05-20;507458;204134;0;0;22686713;10596402;1;0;33.8;15.8;0.0;0.0
FR;2021-05-21;489596;220856;0;0;23176309;10817258;1;0;34.5;16.1;0.0;0.0
FR;2021-05-22;347140;108262;0;0;23523449;10925520;1;0;35.0;16.3;0.0;0.0
FR;2021-05-23;161658;26873;0;0;23685107;10952393;1;0;35.3;16.3;0.0;0.0
FR;2021-05-24;263144;53016;0;0;23948251;11005409;1;0;35.7;16.4;0.0;0.0
FR;2021-05-25;400192;225635;0;0;24348443;11231044;1;0;36.3;16.7;0.0;0.0
FR;2021-05-26;413387;226458;0;0;24761830;11457502;1;0;36.9;17.1;0.0;0.0
FR;2021-05-27;449696;265634;0;0;25211526;11723136;1;0;37.6;17.5;0.0;0.0
FR;2021-05-28;429448;317424;0;0;25640974;12040560;1;0;38.2;17.9;0.0;0.0
FR;2021-05-29;298944;182149;0;0;25939918;12222709;1;0;38.6;18.2;0.0;0.0
FR;2021-05-30;107097;42156;0;0;26047015;12264865;1;0;38.8;18.3;0.0;0.0
FR;2021-05-31;357923;241588;1;0;26404938;12506453;2;0;39.3;18.6;0.0;0.0
FR;2021-06-01;430841;302780;1;0;26835779;12809233;3;0;40.0;19.1;0.0;0.0
FR;2021-06-02;419412;278112;0;0;27255191;13087345;3;0;40.6;19.5;0.0;0.0
FR;2021-06-03;464619;313054;0;0;27719810;13400399;3;0;41.3;20.0;0.0;0.0
FR;2021-06-04;455688;361965;1;0;28175498;13762364;4;0;42.0;20.5;0.0;0.0
FR;2021-06-05;304747;222129;0;0;28480245;13984493;4;0;42.4;20.8;0.0;0.0
FR;2021-06-06;133238;61274;0;0;28613483;14045767;4;0;42.6;20.9;0.0;0.0
FR;2021-06-07;339029;298966;0;0;28952512;14344733;4;0;43.1;21.4;0.0;0.0
FR;2021-06-08;393565;337745;0;0;29346077;14682478;4;0;43.7;21.9;0.0;0.0
FR;2021-06-09;384669;319813;0;0;29730746;15002291;4;0;44.3;22.4;0.0;0.0
FR;2021-06-10;403960;338292;0;0;30134706;15340583;4;0;44.9;22.9;0.0;0.0
FR;2021-06-11;386464;407529;0;0;30521170;15748112;4;0;45.5;23.5;0.0;0.0
FR;2021-06-12;283203;243385;0;0;30804373;15991497;4;0;45.9;23.8;0.0;0.0
FR;2021-06-13;104828;84991;0;0;30909201;16076488;4;0;46.1;24.0;0.0;0.0
FR;2021-06-14;240650;384607;0;0;31149851;16461095;4;0;46.4;24.5;0.0;0.0
FR;2021-06-15;307984;424292;0;0;31457835;16885387;4;0;46.9;25.2;0.0;0.0
FR;2021-06-16;313836;395504;0;0;31771671;17280891;4;0;47.3;25.7;0.0;0.0
FR;2021-06-17;317557;413579;0;0;32089228;17694470;4;0;47.8;26.4;0.0;0.0
FR;2021-06-18;321554;485753;0;0;32410782;18180223;4;0;48.3;27.1;0.0;0.0
FR;2021-06-19;224304;300941;0;0;32635086;18481164;4;0;48.6;27.5;0.0;0.0
FR;2021-06-20;74367;111781;0;0;32709453;18592945;4;0;48.7;27.7;0.0;0.0
FR;2021-06-21;195569;427774;1;0;32905022;19020719;5;0;49.0;28.3;0.0;0.0
FR;2021-06-22;223003;499936;2;0;33128025;19520655;7;0;49.4;29.1;0.0;0.0
FR;2021-06-23;233866;474016;1;0;33361891;19994671;8;0;49.7;29.8;0.0;0.0
FR;2021-06-24;241729;447085;0;0;33603620;20441756;8;0;50.1;30.5;0.0;0.0
FR;2021-06-25;227466;561225;0;0;33831086;21002981;8;0;50.4;31.3;0.0;0.0
FR;2021-06-26;153192;395482;0;0;33984278;21398463;8;0;50.6;31.9;0.0;0.0
FR;2021-06-27;55862;165125;0;0;34040140;21563588;8;0;50.7;32.1;0.0;0.0
FR;2021-06-28;154615;478409;0;0;34194755;22041997;8;0;50.9;32.8;0.0;0.0
FR;2021-06-29;182543;538283;0;0;34377298;22580280;8;0;51.2;33.6;0.0;0.0
FR;2021-06-30;203837;516919;2;0;34581135;23097199;10;0;51.5;34.4;0.0;0.0
FR;2021-07-01;231104;497918;1;0;34812239;23595117;11;0;51.9;35.2;0.0;0.0
FR;2021-07-02;228328;562676;3;0;35040567;24157793;14;0;52.2;36.0;0.0;0.0
FR;2021-07-03;141932;395310;1;0;35182499;24553103;15;0;52.4;36.6;0.0;0.0
FR;2021-07-04;56693;150966;0;0;35239192;24704069;15;0;52.5;36.8;0.0;0.0
FR;2021-07-05;168224;449376;2;0;35407416;25153445;17;0;52.8;37.5;0.0;0.0
FR;2021-07-06;196556;511522;8;0;35603972;25664967;25;0;53.0;38.2;0.0;0.0
FR;2021-07-07;212946;477917;5;0;35816918;26142884;30;0;53.4;39.0;0.0;0.0
FR;2021-07-08;231439;468297;7;0;36048357;26611181;37;0;53.7;39.7;0.0;0.0
FR;2021-07-09;228344;557223;2;0;36276701;27168404;39;0;54.1;40.5;0.0;0.0
FR;2021-07-10;148531;368910;1;0;36425232;27537314;40;0;54.3;41.0;0.0;0.0
FR;2021-07-11;60142;121099;0;0;36485374;27658413;40;0;54.4;41.2;0.0;0.0
FR;2021-07-12;168956;513153;0;0;36654330;28171566;40;0;54.6;42.0;0.0;0.0
FR;2021-07-13;287068;586732;2;0;36941398;28758298;42;0;55.0;42.8;0.0;0.0
FR;2021-07-14;180893;187141;0;0;37122291;28945439;42;0;55.3;43.1;0.0;0.0
FR;2021-07-15;346872;572758;0;0;37469163;29518197;42;0;55.8;44.0;0.0;0.0
FR;2021-07-16;379903;575402;1;0;37849066;30093599;43;0;56.4;44.8;0.0;0.0
FR;2021-07-17;259652;368942;0;0;38108718;30462541;43;0;56.8;45.4;0.0;0.0
FR;2021-07-18;109666;133304;0;0;38218384;30595845;43;0;56.9;45.6;0.0;0.0
FR;2021-07-19;285313;480228;0;0;38503697;31076073;43;0;57.4;46.3;0.0;0.0
FR;2021-07-20;376724;524950;0;0;38880421;31601023;43;0;57.9;47.1;0.0;0.0
FR;2021-07-21;395630;483118;2;0;39276051;32084141;45;0;58.5;47.8;0.0;0.0
FR;2021-07-22;440877;472805;2;0;39716928;32556946;47;0;59.2;48.5;0.0;0.0
FR;2021-07-23;439885;511364;2;0;40156813;33068310;49;0;59.8;49.3;0.0;0.0
FR;2021-07-24;285179;322359;0;0;40441992;33390669;49;0;60.3;49.8;0.0;0.0
FR;2021-07-25;121053;100462;0;0;40563045;33491131;49;0;60.4;49.9;0.0;0.0
FR;2021-07-26;347271;385958;2;0;40910316;33877089;51;0;61.0;50.5;0.0;0.0
FR;2021-07-27;463886;401652;2;0;41374202;34278741;53;0;61.6;51.1;0.0;0.0
FR;2021-07-28;459301;367891;2;0;41833503;34646632;55;0;62.3;51.6;0.0;0.0
FR;2021-07-29;489678;358062;1;0;42323181;35004694;56;0;63.1;52.2;0.0;0.0
FR;2021-07-30;461634;381631;2;0;42784815;35386325;58;0;63.7;52.7;0.0;0.0
FR;2021-07-31;285339;231698;0;0;43070154;35618023;58;0;64.2;53.1;0.0;0.0
FR;2021-08-01;111936;65827;0;0;43182090;35683850;58;0;64.3;53.2;0.0;0.0
FR;2021-08-02;341211;285555;0;0;43523301;35969405;58;0;64.8;53.6;0.0;0.0
FR;2021-08-03;398413;305444;1;0;43921714;36274849;59;0;65.4;54.0;0.0;0.0
FR;2021-08-04;384632;266503;3;0;44306346;36541352;62;0;66.0;54.4;0.0;0.0
FR;2021-08-05;365975;282609;0;0;44672321;36823961;62;0;66.6;54.9;0.0;0.0
FR;2021-08-06;359560;327387;1;0;45031881;37151348;63;0;67.1;55.4;0.0;0.0
FR;2021-08-07;213035;210259;3;0;45244916;37361607;66;0;67.4;55.7;0.0;0.0
FR;2021-08-08;74133;73739;0;0;45319049;37435346;66;0;67.5;55.8;0.0;0.0
FR;2021-08-09;258577;298653;3;0;45577626;37733999;69;0;67.9;56.2;0.0;0.0
FR;2021-08-10;306603;324689;1;0;45884229;38058688;70;0;68.4;56.7;0.0;0.0
FR;2021-08-11;279527;302627;1;0;46163756;38361315;71;0;68.8;57.2;0.0;0.0
FR;2021-08-12;271375;321193;1;0;46435131;38682508;72;0;69.2;57.6;0.0;0.0
FR;2021-08-13;252035;317039;2;0;46687166;38999547;74;0;69.6;58.1;0.0;0.0
FR;2021-08-14;145278;219412;0;0;46832444;39218959;74;0;69.8;58.4;0.0;0.0
FR;2021-08-15;39305;55732;0;0;46871749;39274691;74;0;69.8;58.5;0.0;0.0
FR;2021-08-16;186041;346332;0;0;47057790;39621023;74;0;70.1;59.0;0.0;0.0
FR;2021-08-17;215559;369920;1;0;47273349;39990943;75;0;70.4;59.6;0.0;0.0
FR;2021-08-18;198925;355262;4;0;47472274;40346205;79;0;70.7;60.1;0.0;0.0
FR;2021-08-19;191890;356629;0;0;47664164;40702834;79;0;71.0;60.6;0.0;0.0
FR;2021-08-20;186350;397159;2;0;47850514;41099993;81;0;71.3;61.2;0.0;0.0
FR;2021-08-21;104753;254749;0;0;47955267;41354742;81;0;71.5;61.6;0.0;0.0
FR;2021-08-22;31888;92212;1;0;47987155;41446954;82;0;71.5;61.8;0.0;0.0
FR;2021-08-23;140888;380205;2;0;48128043;41827159;84;0;71.7;62.3;0.0;0.0
FR;2021-08-24;162402;403569;1;0;48290445;42230728;85;0;72.0;62.9;0.0;0.0
FR;2021-08-25;151059;376041;3;0;48441504;42606769;88;0;72.2;63.5;0.0;0.0
FR;2021-08-26;142738;368346;1;0;48584242;42975115;89;0;72.4;64.0;0.0;0.0
FR;2021-08-27;148362;415579;3;0;48732604;43390694;92;0;72.6;64.7;0.0;0.0
FR;2021-08-28;90605;265286;0;0;48823209;43655980;92;0;72.7;65.0;0.0;0.0
FR;2021-08-29;27306;88397;0;0;48850515;43744377;92;0;72.8;65.2;0.0;0.0
FR;2021-08-30;117322;342652;6026;1;48967837;44087029;6118;1;73.0;65.7;0.0;0.0
FR;2021-08-31;128715;354215;11882;2;49096552;44441244;18000;3;73.2;66.2;0.0;0.0
FR;2021-09-01;135763;302709;24306;1;49232315;44743953;42306;4;73.4;66.7;0.1;0.0
FR;2021-09-02;112607;262476;28868;1;49344922;45006429;71174;5;73.5;67.1;0.1;0.0
FR;2021-09-03;118194;309695;32957;6;49463116;45316124;104131;11;73.7;67.5;0.2;0.0
FR;2021-09-04;89796;230668;14071;5;49552912;45546792;118202;16;73.8;67.9;0.2;0.0
FR;2021-09-05;21338;48362;4731;0;49574250;45595154;122933;16;73.9;67.9;0.2;0.0
FR;2021-09-06;75324;191205;34243;2;49649574;45786359;157176;18;74.0;68.2;0.2;0.0
FR;2021-09-07;80098;191497;36102;3;49729672;45977856;193278;21;74.1;68.5;0.3;0.0
FR;2021-09-08;89794;216952;32452;6;49819466;46194808;225730;27;74.2;68.8;0.3;0.0
FR;2021-09-09;76670;174524;36527;16;49896136;46369332;262257;43;74.3;69.1;0.4;0.0
FR;2021-09-10;95596;215246;40519;13;49991732;46584578;302776;56;74.5;69.4;0.5;0.0
FR;2021-09-11;66762;178303;14311;1;50058494;46762881;317087;57;74.6;69.7;0.5;0.0
FR;2021-09-12;12793;34159;3159;2;50071287;46797040;320246;59;74.6;69.7;0.5;0.0
FR;2021-09-13;64371;134678;44048;29;50135658;46931718;364294;88;74.7;69.9;0.5;0.0
FR;2021-09-14;73320;136301;62031;52;50208978;47068019;426325;140;74.8;70.1;0.6;0.0
FR;2021-09-15;76408;174882;54773;99;50285386;47242901;481098;239;74.9;70.4;0.7;0.0
FR;2021-09-16;63757;117981;60015;125;50349143;47360882;541113;364;75.0;70.6;0.8;0.0
FR;2021-09-17;74965;159834;57234;93;50424108;47520716;598347;457;75.1;70.8;0.9;0.0
FR;2021-09-18;48188;144339;17283;24;50472296;47665055;615630;481;75.2;71.0;0.9;0.0
FR;2021-09-19;7866;24930;2619;3;50480162;47689985;618249;484;75.2;71.1;0.9;0.0
FR;2021-09-20;44444;96445;50252;55;50524606;47786430;668501;539;75.3;71.2;1.0;0.0
FR;2021-09-21;45807;98505;63368;127;50570413;47884935;731869;666;75.3;71.3;1.1;0.0
FR;2021-09-22;48586;144830;55349;68;50618999;48029765;787218;734;75.4;71.6;1.2;0.0
FR;2021-09-23;43162;91251;63472;121;50662161;48121016;850690;855;75.5;71.7;1.3;0.0
FR;2021-09-24;52205;132465;59087;104;50714366;48253481;909777;959;75.6;71.9;1.4;0.0
FR;2021-09-25;35192;118568;18254;27;50749558;48372049;928031;986;75.6;72.1;1.4;0.0
FR;2021-09-26;5523;18691;2329;5;50755081;48390740;930360;991;75.6;72.1;1.4;0.0
FR;2021-09-27;33920;78888;48126;113;50789001;48469628;978486;1104;75.7;72.2;1.5;0.0
FR;2021-09-28;36445;74410;56462;82;50825446;48544038;1034948;1186;75.7;72.3;1.5;0.0
FR;2021-09-29;44315;103039;54809;77;50869761;48647077;1089757;1263;75.8;72.5;1.6;0.0
FR;2021-09-30;36270;71394;59474;85;50906031;48718471;1149231;1348;75.8;72.6;1.7;0.0
FR;2021-10-01;61521;99708;63683;54;50967552;48818179;1212914;1402;75.9;72.7;1.8;0.0
FR;2021-10-02;39414;81682;23317;18;51006966;48899861;1236231;1420;76.0;72.9;1.8;0.0
FR;2021-10-03;5261;11291;2540;4;51012227;48911152;1238771;1424;76.0;72.9;1.8;0.0
FR;2021-10-04;34959;59571;54778;82;51047186;48970723;1293549;1506;76.1;73.0;1.9;0.0
FR;2021-10-05;33564;62204;64915;73;51080750;49032927;1358464;1579;76.1;73.1;2.0;0.0
FR;2021-10-06;42430;80229;68224;42;51123180;49113156;1426688;1621;76.2;73.2;2.1;0.0
FR;2021-10-07;30397;59478;68662;87;51153577;49172634;1495350;1708;76.2;73.3;2.2;0.0
FR;2021-10-08;48746;89894;84617;69;51202323;49262528;1579967;1777;76.3;73.4;2.4;0.0
FR;2021-10-09;33622;64135;33854;20;51235945;49326663;1613821;1797;76.3;73.5;2.4;0.0
FR;2021-10-10;4612;7933;3483;2;51240557;49334596;1617304;1799;76.3;73.5;2.4;0.0
FR;2021-10-11;30559;50653;64020;94;51271116;49385249;1681324;1893;76.4;73.6;2.5;0.0
FR;2021-10-12;31359;51434;75828;58;51302475;49436683;1757152;1951;76.4;73.7;2.6;0.0
FR;2021-10-13;39986;62837;79246;51;51342461;49499520;1836398;2002;76.5;73.8;2.7;0.0
FR;2021-10-14;30231;49758;73756;49;51372692;49549278;1910154;2051;76.5;73.8;2.8;0.0
FR;2021-10-15;44737;70458;102892;59;51417429;49619736;2013046;2110;76.6;73.9;3.0;0.0
FR;2021-10-16;31269;46722;39607;23;51448698;49666458;2052653;2133;76.7;74.0;3.1;0.0
FR;2021-10-17;3827;5692;3691;3;51452525;49672150;2056344;2136;76.7;74.0;3.1;0.0
FR;2021-10-18;28321;42677;71331;36;51480846;49714827;2127675;2172;76.7;74.1;3.2;0.0
FR;2021-10-19;27053;42257;81603;71;51507899;49757084;2209278;2243;76.7;74.1;3.3;0.0
FR;2021-10-20;35202;51886;101461;93;51543101;49808970;2310739;2336;76.8;74.2;3.4;0.0
FR;2021-10-21;25941;42017;89106;45;51569042;49850987;2399845;2381;76.8;74.3;3.6;0.0
FR;2021-10-22;38207;59329;112479;91;51607249;49910316;2512324;2472;76.9;74.4;3.7;0.0
FR;2021-10-23;26969;42455;48595;24;51634218;49952771;2560919;2496;76.9;74.4;3.8;0.0
FR;2021-10-24;2912;5022;3937;3;51637130;49957793;2564856;2499;76.9;74.4;3.8;0.0
FR;2021-10-25;25971;35636;86597;67;51663101;49993429;2651453;2566;77.0;74.5;4.0;0.0
FR;2021-10-26;23683;32303;92312;48;51686784;50025732;2743765;2614;77.0;74.5;4.1;0.0
FR;2021-10-27;30006;44205;114611;73;51716790;50069937;2858376;2687;77.1;74.6;4.3;0.0
FR;2021-10-28;23384;31206;94386;61;51740174;50101143;2952762;2748;77.1;74.6;4.4;0.0
FR;2021-10-29;31505;46527;125247;78;51771679;50147670;3078009;2826;77.1;74.7;4.6;0.0
FR;2021-10-30;20524;32845;53354;27;51792203;50180515;3131363;2853;77.2;74.8;4.7;0.0
FR;2021-10-31;2479;3873;3868;3;51794682;50184388;3135231;2856;77.2;74.8;4.7;0.0
FR;2021-11-01;8199;4958;3555;10;51802881;50189346;3138786;2866;77.2;74.8;4.7;0.0
FR;2021-11-02;25290;36352;99467;63;51828171;50225698;3238253;2929;77.2;74.8;4.8;0.0
FR;2021-11-03;29760;43600;125790;96;51857931;50269298;3364043;3025;77.3;74.9;5.0;0.0
FR;2021-11-04;23665;31634;114319;68;51881596;50300932;3478362;3093;77.3;74.9;5.2;0.0
FR;2021-11-05;32269;44712;151254;86;51913865;50345644;3629616;3179;77.4;75.0;5.4;0.0
FR;2021-11-06;21479;32457;68227;39;51935344;50378101;3697843;3218;77.4;75.1;5.5;0.0
FR;2021-11-07;2378;4057;5586;8;51937722;50382158;3703429;3226;77.4;75.1;5.5;0.0
FR;2021-11-08;20410;31080;134148;73;51958132;50413238;3837577;3299;77.4;75.1;5.7;0.0
FR;2021-11-09;22134;33101;172105;107;51980266;50446339;4009682;3406;77.4;75.2;6.0;0.0
FR;2021-11-10;31376;44259;198675;127;52011642;50490598;4208357;3533;77.5;75.2;6.3;0.0
FR;2021-11-11;4309;5865;13925;20;52015951;50496463;4222282;3553;77.5;75.2;6.3;0.0
FR;2021-11-12;28990;41892;197254;126;52044941;50538355;4419536;3679;77.5;75.3;6.6;0.0
FR;2021-11-13;20298;28355;86288;60;52065239;50566710;4505824;3739;77.6;75.3;6.7;0.0
FR;2021-11-14;2333;3408;7875;10;52067572;50570118;4513699;3749;77.6;75.3;6.7;0.0
FR;2021-11-15;20299;28066;171445;102;52087871;50598184;4685144;3851;77.6;75.4;7.0;0.0
FR;2021-11-16;23353;28004;214865;152;52111224;50626188;4900009;4003;77.6;75.4;7.3;0.0
FR;2021-11-17;30351;36711;212785;132;52141575;50662899;5112794;4135;77.7;75.5;7.6;0.0
FR;2021-11-18;23349;28842;205397;123;52164924;50691741;5318191;4258;77.7;75.5;7.9;0.0
FR;2021-11-19;33556;40092;262063;185;52198480;50731833;5580254;4443;77.8;75.6;8.3;0.0
FR;2021-11-20;25323;29402;109663;63;52223803;50761235;5689917;4506;77.8;75.6;8.5;0.0
FR;2021-11-21;2623;3483;10644;17;52226426;50764718;5700561;4523;77.8;75.6;8.5;0.0
FR;2021-11-22;22740;19174;194750;85;52249166;50783892;5895311;4608;77.9;75.7;8.8;0.0
FR;2021-11-23;25563;24458;247719;82;52274729;50808350;6143030;4690;77.9;75.7;9.2;0.0
FR;2021-11-24;31764;34771;243121;80;52306493;50843121;6386151;4770;77.9;75.8;9.5;0.0
FR;2021-11-25;25385;25196;277561;111;52331878;50868317;6663712;4881;78.0;75.8;9.9;0.0
FR;2021-11-26;33202;37582;414500;160;52365080;50905899;7078212;5041;78.0;75.8;10.5;0.0
FR;2021-11-27;23308;28648;236558;148;52388388;50934547;7314770;5189;78.1;75.9;10.9;0.0
FR;2021-11-28;3479;4129;63330;41;52391867;50938676;7378100;5230;78.1;75.9;11.0;0.0
FR;2021-11-29;19385;23457;371543;175;52411252;50962133;7749643;5405;78.1;75.9;11.5;0.0
FR;2021-11-30;24730;27261;500634;280;52435982;50989394;8250277;5685;78.1;76.0;12.3;0.0
FR;2021-12-01;26900;31875;511180;300;52462882;51021269;8761457;5985;78.2;76.0;13.1;0.0
FR;2021-12-02;21978;21388;574690;302;52484860;51042657;9336147;6287;78.2;76.1;13.9;0.0
FR;2021-12-03;25477;34144;650968;325;52510337;51076801;9987115;6612;78.2;76.1;14.9;0.0
FR;2021-12-04;18288;25913;369689;216;52528625;51102714;10356804;6828;78.3;76.1;15.4;0.0
FR;2021-12-05;4142;4965;107051;94;52532767;51107679;10463855;6922;78.3;76.1;15.6;0.0
FR;2021-12-06;22985;25749;539812;383;52555752;51133428;11003667;7305;78.3;76.2;16.4;0.0
FR;2021-12-07;23314;29170;706143;407;52579066;51162598;11709810;7712;78.3;76.2;17.4;0.0
FR;2021-12-08;25343;35456;647339;435;52604409;51198054;12357149;8147;78.4;76.3;18.4;0.0
FR;2021-12-09;23995;29497;726173;454;52628404;51227551;13083322;8601;78.4;76.3;19.5;0.0
FR;2021-12-10;27707;38321;805966;463;52656111;51265872;13889288;9064;78.5;76.4;20.7;0.0
FR;2021-12-11;20223;29945;480318;353;52676334;51295817;14369606;9417;78.5;76.4;21.4;0.0
FR;2021-12-12;5624;6464;159229;107;52681958;51302281;14528835;9524;78.5;76.4;21.6;0.0
FR;2021-12-13;21063;30179;649182;393;52703021;51332460;15178017;9917;78.5;76.5;22.6;0.0
FR;2021-12-14;27579;35850;847356;682;52730600;51368310;16025373;10599;78.6;76.5;23.9;0.0
FR;2021-12-15;28211;39930;768912;491;52758811;51408240;16794285;11090;78.6;76.6;25.0;0.0
FR;2021-12-16;27937;35611;844260;504;52786748;51443851;17638545;11594;78.7;76.7;26.3;0.0
FR;2021-12-17;31546;43777;891979;593;52818294;51487628;18530524;12187;78.7;76.7;27.6;0.0
FR;2021-12-18;24913;30245;522144;365;52843207;51517873;19052668;12552;78.7;76.8;28.4;0.0
FR;2021-12-19;8741;7970;191144;140;52851948;51525843;19243812;12692;78.7;76.8;28.7;0.0
FR;2021-12-20;31589;34249;658605;488;52883537;51560092;19902417;13180;78.8;76.8;29.7;0.0
FR;2021-12-21;39216;39247;759460;578;52922753;51599339;20661877;13758;78.9;76.9;30.8;0.0
FR;2021-12-22;39467;37489;642027;702;52962220;51636828;21303904;14460;78.9;76.9;31.7;0.0
FR;2021-12-23;33742;30394;494320;592;52995962;51667222;21798224;15052;79.0;77.0;32.5;0.0
FR;2021-12-24;10664;11618;126641;240;53006626;51678840;21924865;15292;79.0;77.0;32.7;0.0
FR;2021-12-25;768;1938;9028;72;53007394;51680778;21933893;15364;79.0;77.0;32.7;0.0
FR;2021-12-26;4696;4765;60132;169;53012090;51685543;21994025;15533;79.0;77.0;32.8;0.0
FR;2021-12-27;30382;33162;509084;673;53042472;51718705;22503109;16206;79.0;77.1;33.5;0.0
FR;2021-12-28;38312;35312;632159;1555;53080784;51754017;23135268;17761;79.1;77.1;34.5;0.0
FR;2021-12-29;39843;33283;560918;1751;53120627;51787300;23696186;19512;79.1;77.2;35.3;0.0
FR;2021-12-30;35887;29454;471094;1881;53156514;51816754;24167280;21393;79.2;77.2;36.0;0.0
FR;2021-12-31;12035;11336;131615;755;53168549;51828090;24298895;22148;79.2;77.2;36.2;0.0
FR;2022-01-01;1350;1765;9929;100;53169899;51829855;24308824;22248;79.2;77.2;36.2;0.0
FR;2022-01-02;6075;5085;66934;408;53175974;51834940;24375758;22656;79.2;77.2;36.3;0.0
FR;2022-01-03;32702;36642;551484;2642;53208676;51871582;24927242;25298;79.3;77.3;37.1;0.0
FR;2022-01-04;40920;40511;714212;3839;53249596;51912093;25641454;29137;79.3;77.3;38.2;0.0
FR;2022-01-05;60358;43441;634055;3436;53309954;51955534;26275509;32573;79.4;77.4;39.1;0.0
FR;2022-01-06;43953;40059;711314;4564;53353907;51995593;26986823;37137;79.5;77.5;40.2;0.1
FR;2022-01-07;50565;46595;790329;5005;53404472;52042188;27777152;42142;79.6;77.5;41.4;0.1
FR;2022-01-08;44949;35018;472842;2444;53449421;52077206;28249994;44586;79.6;77.6;42.1;0.1
FR;2022-01-09;15596;11492;145698;830;53465017;52088698;28395692;45416;79.7;77.6;42.3;0.1
FR;2022-01-10;35035;38616;522191;3719;53500052;52127314;28917883;49135;79.7;77.7;43.1;0.1
FR;2022-01-11;41649;42096;608385;5215;53541701;52169410;29526268;54350;79.8;77.7;44.0;0.1
FR;2022-01-12;60166;49233;504227;4492;53601867;52218643;30030495;58842;79.9;77.8;44.7;0.1
FR;2022-01-13;37916;40314;540947;5461;53639783;52258957;30571442;64303;79.9;77.9;45.6;0.1
FR;2022-01-14;42388;43353;628955;6460;53682171;52302310;31200397;70763;80.0;77.9;46.5;0.1
FR;2022-01-15;39305;31290;377541;3293;53721476;52333600;31577938;74056;80.0;78.0;47.1;0.1
FR;2022-01-16;11382;9014;99448;760;53732858;52342614;31677386;74816;80.1;78.0;47.2;0.1
FR;2022-01-17;24600;28034;354121;3961;53757458;52370648;32031507;78777;80.1;78.0;47.7;0.1
FR;2022-01-18;28103;31768;397505;5774;53785561;52402416;32429012;84551;80.1;78.1;48.3;0.1
FR;2022-01-19;43050;40277;311050;4385;53828611;52442693;32740062;88936;80.2;78.1;48.8;0.1
FR;2022-01-20;23417;29333;328412;5627;53852028;52472026;33068474;94563;80.2;78.2;49.3;0.1
FR;2022-01-21;27988;32968;401118;6583;53880016;52504994;33469592;101146;80.3;78.2;49.9;0.2
FR;2022-01-22;27607;27192;241739;2842;53907623;52532186;33711331;103988;80.3;78.3;50.2;0.2
FR;2022-01-23;6702;7514;55180;590;53914325;52539700;33766511;104578;80.3;78.3;50.3;0.2
FR;2022-01-24;16195;25067;239309;4095;53930520;52564767;34005820;108673;80.4;78.3;50.7;0.2
FR;2022-01-25;18906;28586;267034;6066;53949426;52593353;34272854;114739;80.4;78.4;51.1;0.2
FR;2022-01-26;28111;41061;229341;4474;53977537;52634414;34502195;119213;80.4;78.4;51.4;0.2
FR;2022-01-27;16275;25740;225817;5693;53993812;52660154;34728012;124906;80.4;78.5;51.7;0.2
FR;2022-01-28;21498;41823;321447;7411;54015310;52701977;35049459;132317;80.5;78.5;52.2;0.2
FR;2022-01-29;18401;32670;204569;3249;54033711;52734647;35254028;135566;80.5;78.6;52.5;0.2
FR;2022-01-30;4466;9153;45089;639;54038177;52743800;35299117;136205;80.5;78.6;52.6;0.2
FR;2022-01-31;11220;25956;164777;4243;54049397;52769756;35463894;140448;80.5;78.6;52.8;0.2
FR;2022-02-01;12812;27110;191361;7100;54062209;52796866;35655255;147548;80.6;78.7;53.1;0.2
FR;2022-02-02;20052;45681;190118;5993;54082261;52842547;35845373;153541;80.6;78.7;53.4;0.2
FR;2022-02-03;10968;24639;173294;6967;54093229;52867186;36018667;160508;80.6;78.8;53.7;0.2
FR;2022-02-04;14489;35945;264167;9206;54107718;52903131;36282834;169714;80.6;78.8;54.1;0.3
FR;2022-02-05;12782;31921;172335;3817;54120500;52935052;36455169;173531;80.6;78.9;54.3;0.3
FR;2022-02-06;2705;7325;33825;663;54123205;52942377;36488994;174194;80.6;78.9;54.4;0.3
FR;2022-02-07;9344;24434;176311;5290;54132549;52966811;36665305;179484;80.7;78.9;54.6;0.3
FR;2022-02-08;9596;20534;184324;7049;54142145;52987345;36849629;186533;80.7;79.0;54.9;0.3
FR;2022-02-09;14164;34983;192960;5778;54156309;53022328;37042589;192311;80.7;79.0;55.2;0.3
FR;2022-02-10;8269;17884;166580;6497;54164578;53040212;37209169;198808;80.7;79.0;55.4;0.3
FR;2022-02-11;10758;25603;243002;8324;54175336;53065815;37452171;207132;80.7;79.1;55.8;0.3
FR;2022-02-12;8347;22553;151705;3502;54183683;53088368;37603876;210634;80.7;79.1;56.0;0.3
FR;2022-02-13;1895;4390;30903;540;54185578;53092758;37634779;211174;80.7;79.1;56.1;0.3
FR;2022-02-14;6906;14504;166305;4774;54192484;53107262;37801084;215948;80.7;79.1;56.3;0.3
FR;2022-02-15;6851;15247;162442;6846;54199335;53122509;37963526;222794;80.8;79.2;56.6;0.3
FR;2022-02-16;9291;25615;146651;5720;54208626;53148124;38110177;228514;80.8;79.2;56.8;0.3
FR;2022-02-17;5373;12571;94761;5403;54213999;53160695;38204938;233917;80.8;79.2;56.9;0.3
FR;2022-02-18;6877;18427;129244;7399;54220876;53179122;38334182;241316;80.8;79.2;57.1;0.4
FR;2022-02-19;5341;15803;77300;3016;54226217;53194925;38411482;244332;80.8;79.3;57.2;0.4
FR;2022-02-20;1136;2882;13925;459;54227353;53197807;38425407;244791;80.8;79.3;57.3;0.4
FR;2022-02-21;4021;10039;67137;4057;54231374;53207846;38492544;248848;80.8;79.3;57.4;0.4
FR;2022-02-22;4373;11100;64408;5249;54235747;53218946;38556952;254097;80.8;79.3;57.4;0.4
FR;2022-02-23;6510;19394;71859;4590;54242257;53238340;38628811;258687;80.8;79.3;57.6;0.4
FR;2022-02-24;3743;9132;53183;4530;54246000;53247472;38681994;263217;80.8;79.3;57.6;0.4
FR;2022-02-25;5199;14530;79999;7327;54251199;53262002;38761993;270544;80.8;79.4;57.8;0.4
FR;2022-02-26;3970;12036;51453;3083;54255169;53274038;38813446;273627;80.8;79.4;57.8;0.4
FR;2022-02-27;870;1956;8933;529;54256039;53275994;38822379;274156;80.8;79.4;57.8;0.4
FR;2022-02-28;3068;7248;42877;3850;54259107;53283242;38865256;278006;80.8;79.4;57.9;0.4
FR;2022-03-01;3131;7285;44763;5509;54262238;53290527;38910019;283515;80.8;79.4;58.0;0.4
FR;2022-03-02;5079;12525;48989;4921;54267317;53303052;38959008;288436;80.9;79.4;58.0;0.4
FR;2022-03-03;2649;5820;29922;4043;54269966;53308872;38988930;292479;80.9;79.4;58.1;0.4
FR;2022-03-04;3178;8188;39387;6208;54273144;53317060;39028317;298687;80.9;79.4;58.2;0.4
FR;2022-03-05;2919;7060;25075;3130;54276063;53324120;39053392;301817;80.9;79.5;58.2;0.4
FR;2022-03-06;509;1011;3429;378;54276572;53325131;39056821;302195;80.9;79.5;58.2;0.5
FR;2022-03-07;1944;3698;17652;3298;54278516;53328829;39074473;305493;80.9;79.5;58.2;0.5
FR;2022-03-08;1967;4151;17860;4088;54280483;53332980;39092333;309581;80.9;79.5;58.2;0.5
FR;2022-03-09;3448;8512;21225;4030;54283931;53341492;39113558;313611;80.9;79.5;58.3;0.5
FR;2022-03-10;1710;3800;15685;3394;54285641;53345292;39129243;317005;80.9;79.5;58.3;0.5
FR;2022-03-11;2343;5173;22223;5469;54287984;53350465;39151466;322474;80.9;79.5;58.3;0.5
FR;2022-03-12;2656;5426;16498;3132;54290640;53355891;39167964;325606;80.9;79.5;58.4;0.5
FR;2022-03-13;386;589;2254;529;54291026;53356480;39170218;326135;80.9;79.5;58.4;0.5
FR;2022-03-14;1462;2675;13785;7280;54292488;53359155;39184003;333415;80.9;79.5;58.4;0.5
FR;2022-03-15;1593;3005;14330;11012;54294081;53362160;39198333;344427;80.9;79.5;58.4;0.5
FR;2022-03-16;2941;5854;18019;16285;54297022;53368014;39216352;360712;80.9;79.5;58.4;0.5
FR;2022-03-17;1370;2512;11933;13294;54298392;53370526;39228285;374006;80.9;79.5;58.4;0.6
FR;2022-03-18;2197;3863;18023;22012;54300589;53374389;39246308;396018;80.9;79.5;58.5;0.6
FR;2022-03-19;2275;3996;12398;11402;54302864;53378385;39258706;407420;80.9;79.5;58.5;0.6
FR;2022-03-20;293;503;1917;1332;54303157;53378888;39260623;408752;80.9;79.5;58.5;0.6
FR;2022-03-21;1341;2060;11908;16900;54304498;53380948;39272531;425652;80.9;79.5;58.5;0.6
FR;2022-03-22;1460;2423;12510;22811;54305958;53383371;39285041;448463;80.9;79.5;58.5;0.7
FR;2022-03-23;2633;5007;17146;25242;54308591;53388378;39302187;473705;80.9;79.5;58.6;0.7
FR;2022-03-24;1356;2012;10614;19351;54309947;53390390;39312801;493056;80.9;79.6;58.6;0.7
FR;2022-03-25;2045;3330;16824;30776;54311992;53393720;39329625;523832;80.9;79.6;58.6;0.8
FR;2022-03-26;2215;3692;11497;14379;54314207;53397412;39341122;538211;80.9;79.6;58.6;0.8
FR;2022-03-27;354;501;1908;1730;54314561;53397913;39343030;539941;80.9;79.6;58.6;0.8
FR;2022-03-28;1410;1959;10541;19025;54315971;53399872;39353571;558966;80.9;79.6;58.6;0.8
FR;2022-03-29;1419;2025;12006;29229;54317390;53401897;39365577;588195;80.9;79.6;58.7;0.9
FR;2022-03-30;2810;4546;14995;29250;54320200;53406443;39380572;617445;80.9;79.6;58.7;0.9
FR;2022-03-31;1589;2118;12186;26491;54321789;53408561;39392758;643936;80.9;79.6;58.7;1.0
FR;2022-04-01;2084;2651;18592;33406;54323873;53411212;39411350;677342;80.9;79.6;58.7;1.0
FR;2022-04-02;1491;1967;8686;11266;54325364;53413179;39420036;688608;80.9;79.6;58.7;1.0
FR;2022-04-03;273;338;1570;1378;54325637;53413517;39421606;689986;80.9;79.6;58.7;1.0
FR;2022-04-04;1324;1562;11385;20525;54326961;53415079;39432991;710511;80.9;79.6;58.8;1.1
FR;2022-04-05;1581;1795;13082;35586;54328542;53416874;39446073;746097;80.9;79.6;58.8;1.1
FR;2022-04-06;2029;2682;12661;27775;54330571;53419556;39458734;773872;81.0;79.6;58.8;1.2
FR;2022-04-07;1423;1692;12777;34942;54331994;53421248;39471511;808814;81.0;79.6;58.8;1.2
FR;2022-04-08;2012;2398;17730;45995;54334006;53423646;39489241;854809;81.0;79.6;58.8;1.3
FR;2022-04-09;1341;1870;8835;14772;54335347;53425516;39498076;869581;81.0;79.6;58.9;1.3
FR;2022-04-10;273;364;1970;2254;54335620;53425880;39500046;871835;81.0;79.6;58.9;1.3
FR;2022-04-11;1179;1473;11405;24900;54336799;53427353;39511451;896735;81.0;79.6;58.9;1.3
FR;2022-04-12;1560;1652;13267;41437;54338359;53429005;39524718;938172;81.0;79.6;58.9;1.4
FR;2022-04-13;1837;2402;12886;33725;54340196;53431407;39537604;971897;81.0;79.6;58.9;1.4
FR;2022-04-14;1431;1584;12856;36575;54341627;53432991;39550460;1008472;81.0;79.6;58.9;1.5
FR;2022-04-15;1768;2051;14725;36863;54343395;53435042;39565185;1045335;81.0;79.6;59.0;1.6
FR;2022-04-16;1026;1234;6214;9405;54344421;53436276;39571399;1054740;81.0;79.6;59.0;1.6
FR;2022-04-17;183;199;1027;1223;54344604;53436475;39572426;1055963;81.0;79.6;59.0;1.6
FR;2022-04-18;144;233;2742;1247;54344748;53436708;39575168;1057210;81.0;79.6;59.0;1.6
FR;2022-04-19;1460;1739;12338;30449;54346208;53438447;39587506;1087659;81.0;79.6;59.0;1.6
FR;2022-04-20;1888;2421;12816;29730;54348096;53440868;39600322;1117389;81.0;79.6;59.0;1.7
FR;2022-04-21;1466;1687;12417;35292;54349562;53442555;39612739;1152681;81.0;79.6;59.0;1.7
FR;2022-04-22;1813;2211;15738;38906;54351375;53444766;39628477;1191587;81.0;79.6;59.0;1.8
FR;2022-04-23;1115;1439;7197;11418;54352490;53446205;39635674;1203005;81.0;79.6;59.1;1.8
FR;2022-04-24;236;302;1403;1835;54352726;53446507;39637077;1204840;81.0;79.6;59.1;1.8
FR;2022-04-25;1244;1503;10404;21842;54353970;53448010;39647481;1226682;81.0;79.6;59.1;1.8
FR;2022-04-26;1551;1869;12992;38936;54355521;53449879;39660473;1265618;81.0;79.6;59.1;1.9
FR;2022-04-27;1899;2197;11457;30963;54357420;53452076;39671930;1296581;81.0;79.6;59.1;1.9
FR;2022-04-28;1515;1699;12105;35972;54358935;53453775;39684035;1332553;81.0;79.6;59.1;2.0
FR;2022-04-29;1937;2215;14701;38269;54360872;53455990;39698736;1370822;81.0;79.6;59.2;2.0
FR;2022-04-30;1176;1263;6570;10527;54362048;53457253;39705306;1381349;81.0;79.7;59.2;2.1
FR;2022-05-01;169;200;875;1084;54362217;53457453;39706181;1382433;81.0;79.7;59.2;2.1
FR;2022-05-02;1130;1247;10525;18635;54363347;53458700;39716706;1401068;81.0;79.7;59.2;2.1
FR;2022-05-03;1700;1711;13136;34963;54365047;53460411;39729842;1436031;81.0;79.7;59.2;2.1
FR;2022-05-04;1785;1908;11652;25669;54366832;53462319;39741494;1461700;81.0;79.7;59.2;2.2
FR;2022-05-05;1580;1623;11830;33587;54368412;53463942;39753324;1495287;81.0;79.7;59.2;2.2
FR;2022-05-06;2019;2140;14484;37848;54370431;53466082;39767808;1533135;81.0;79.7;59.3;2.3
FR;2022-05-07;1157;1214;6315;10269;54371588;53467296;39774123;1543404;81.0;79.7;59.3;2.3
FR;2022-05-08;250;271;1199;1624;54371838;53467567;39775322;1545028;81.0;79.7;59.3;2.3
FR;2022-05-09;1215;1187;9215;20723;54373053;53468754;39784537;1565751;81.0;79.7;59.3;2.3
FR;2022-05-10;1605;1682;12238;39104;54374658;53470436;39796775;1604855;81.0;79.7;59.3;2.4
FR;2022-05-11;1897;1963;10005;27949;54376555;53472399;39806780;1632804;81.0;79.7;59.3;2.4
FR;2022-05-12;1489;1523;10483;35773;54378044;53473922;39817263;1668577;81.0;79.7;59.3;2.5
FR;2022-05-13;1892;1881;12805;38432;54379936;53475803;39830068;1707009;81.0;79.7;59.3;2.5
FR;2022-05-14;1107;1095;5339;11217;54381043;53476898;39835407;1718226;81.0;79.7;59.4;2.6
FR;2022-05-15;258;217;1206;1543;54381301;53477115;39836613;1719769;81.0;79.7;59.4;2.6
FR;2022-05-16;1106;1052;7588;20792;54382407;53478167;39844201;1740561;81.0;79.7;59.4;2.6
FR;2022-05-17;1500;1468;10288;37729;54383907;53479635;39854489;1778290;81.0;79.7;59.4;2.6
FR;2022-05-18;1707;1734;8476;27035;54385614;53481369;39862965;1805325;81.0;79.7;59.4;2.7
FR;2022-05-19;1354;1414;9421;34700;54386968;53482783;39872386;1840025;81.0;79.7;59.4;2.7
FR;2022-05-20;1793;1830;11384;39338;54388761;53484613;39883770;1879363;81.0;79.7;59.4;2.8
FR;2022-05-21;1123;1211;4920;10226;54389884;53485824;39888690;1889589;81.0;79.7;59.4;2.8
FR;2022-05-22;219;232;947;1453;54390103;53486056;39889637;1891042;81.0;79.7;59.4;2.8
FR;2022-05-23;1049;1135;6837;19906;54391152;53487191;39896474;1910948;81.0;79.7;59.4;2.8
FR;2022-05-24;1424;1508;9733;37433;54392576;53488699;39906207;1948381;81.0;79.7;59.5;2.9
FR;2022-05-25;1676;1801;8281;23602;54394252;53490500;39914488;1971983;81.0;79.7;59.5;2.9
FR;2022-05-26;139;125;740;972;54394391;53490625;39915228;1972955;81.0;79.7;59.5;2.9
