fra;jour;n_dose1;n_complet;n_rappel;n_2_rappel;n_cum_dose1;n_cum_complet;n_cum_rappel;n_cum_2_rappel;couv_dose1;couv_complet;couv_rappel;couv_2_rappel
FR;2020-12-27;602;55;0;0;602;55;0;0;0.0;0.0;0.0;0.0
FR;2020-12-28;669;42;0;0;1271;97;0;0;0.0;0.0;0.0;0.0
FR;2020-12-29;374;19;0;0;1645;116;0;0;0.0;0.0;0.0;0.0
FR;2020-12-30;440;18;0;0;2085;134;0;0;0.0;0.0;0.0;0.0
FR;2020-12-31;436;24;0;0;2521;158;0;0;0.0;0.0;0.0;0.0
FR;2021-01-01;1137;65;0;0;3658;223;0;0;0.0;0.0;0.0;0.0
FR;2021-01-02;359;30;0;0;4017;253;0;0;0.0;0.0;0.0;0.0
FR;2021-01-03;402;27;0;0;4419;280;0;0;0.0;0.0;0.0;0.0
FR;2021-01-04;2093;48;0;0;6512;328;0;0;0.0;0.0;0.0;0.0
FR;2021-01-05;7732;130;0;0;14244;458;0;0;0.0;0.0;0.0;0.0
FR;2021-01-06;12449;121;0;0;26693;579;0;0;0.0;0.0;0.0;0.0
FR;2021-01-07;29449;156;0;0;56142;735;0;0;0.1;0.0;0.0;0.0
FR;2021-01-08;37123;198;0;0;93265;933;0;0;0.1;0.0;0.0;0.0
FR;2021-01-09;11209;75;0;0;104474;1008;0;0;0.2;0.0;0.0;0.0
FR;2021-01-10;5997;24;0;0;110471;1032;0;0;0.2;0.0;0.0;0.0
FR;2021-01-11;39925;223;0;0;150396;1255;0;0;0.2;0.0;0.0;0.0
FR;2021-01-12;62127;311;0;0;212523;1566;0;0;0.3;0.0;0.0;0.0
FR;2021-01-13;65110;426;0;0;277633;1992;0;0;0.4;0.0;0.0;0.0
FR;2021-01-14;83118;1191;0;0;360751;3183;0;0;0.5;0.0;0.0;0.0
FR;2021-01-15;68994;560;0;0;429745;3743;0;0;0.6;0.0;0.0;0.0
FR;2021-01-16;20208;185;0;0;449953;3928;0;0;0.7;0.0;0.0;0.0
FR;2021-01-17;10977;132;0;0;460930;4060;0;0;0.7;0.0;0.0;0.0
FR;2021-01-18;85886;611;0;0;546816;4671;0;0;0.8;0.0;0.0;0.0
FR;2021-01-19;130576;865;0;0;677392;5536;0;0;1.0;0.0;0.0;0.0
FR;2021-01-20;137527;849;0;0;814919;6385;0;0;1.2;0.0;0.0;0.0
FR;2021-01-21;158379;968;0;0;973298;7353;0;0;1.5;0.0;0.0;0.0
FR;2021-01-22;121046;838;0;0;1094344;8191;0;0;1.6;0.0;0.0;0.0
FR;2021-01-23;38467;205;0;0;1132811;8396;0;0;1.7;0.0;0.0;0.0
FR;2021-01-24;9740;139;0;0;1142551;8535;0;0;1.7;0.0;0.0;0.0
FR;2021-01-25;78224;1638;0;0;1220775;10173;0;0;1.8;0.0;0.0;0.0
FR;2021-01-26;100365;3772;0;0;1321140;13945;0;0;2.0;0.0;0.0;0.0
FR;2021-01-27;107223;6674;0;0;1428363;20619;0;0;2.1;0.0;0.0;0.0
FR;2021-01-28;124331;15905;0;0;1552694;36524;0;0;2.3;0.1;0.0;0.0
FR;2021-01-29;92173;18337;0;0;1644867;54861;0;0;2.5;0.1;0.0;0.0
FR;2021-01-30;29114;4430;0;0;1673981;59291;0;0;2.5;0.1;0.0;0.0
FR;2021-01-31;5228;1779;0;0;1679209;61070;0;0;2.5;0.1;0.0;0.0
FR;2021-02-01;53108;21798;0;0;1732317;82868;0;0;2.6;0.1;0.0;0.0
FR;2021-02-02;72283;36305;0;0;1804600;119173;0;0;2.7;0.2;0.0;0.0
FR;2021-02-03;72291;38587;0;0;1876891;157760;0;0;2.8;0.2;0.0;0.0
FR;2021-02-04;82053;52205;0;0;1958944;209965;0;0;2.9;0.3;0.0;0.0
FR;2021-02-05;68217;46469;0;0;2027161;256434;0;0;3.0;0.4;0.0;0.0
FR;2021-02-06;23101;10993;0;0;2050262;267427;0;0;3.1;0.4;0.0;0.0
FR;2021-02-07;5183;5432;0;0;2055445;272859;0;0;3.1;0.4;0.0;0.0
FR;2021-02-08;46819;47308;0;0;2102264;320167;0;0;3.1;0.5;0.0;0.0
FR;2021-02-09;65993;75657;0;0;2168257;395824;0;0;3.2;0.6;0.0;0.0
FR;2021-02-10;70991;80693;0;0;2239248;476517;0;0;3.3;0.7;0.0;0.0
FR;2021-02-11;87243;103264;0;0;2326491;579781;0;0;3.5;0.9;0.0;0.0
FR;2021-02-12;79295;76674;0;0;2405786;656455;0;0;3.6;1.0;0.0;0.0
FR;2021-02-13;22355;19807;0;0;2428141;676262;0;0;3.6;1.0;0.0;0.0
FR;2021-02-14;5071;7391;0;0;2433212;683653;0;0;3.6;1.0;0.0;0.0
FR;2021-02-15;38072;77412;0;0;2471284;761065;0;0;3.7;1.1;0.0;0.0
FR;2021-02-16;50365;101642;0;0;2521649;862707;0;0;3.8;1.3;0.0;0.0
FR;2021-02-17;50503;105919;0;0;2572152;968626;0;0;3.8;1.4;0.0;0.0
FR;2021-02-18;69763;122566;0;0;2641915;1091192;0;0;3.9;1.6;0.0;0.0
FR;2021-02-19;65052;92793;0;0;2706967;1183985;0;0;4.0;1.8;0.0;0.0
FR;2021-02-20;18576;28865;0;0;2725543;1212850;0;0;4.1;1.8;0.0;0.0
FR;2021-02-21;3314;6368;0;0;2728857;1219218;0;0;4.1;1.8;0.0;0.0
FR;2021-02-22;37483;74021;0;0;2766340;1293239;0;0;4.1;1.9;0.0;0.0
FR;2021-02-23;53763;85812;0;0;2820103;1379051;0;0;4.2;2.1;0.0;0.0
FR;2021-02-24;59983;83217;0;0;2880086;1462268;0;0;4.3;2.2;0.0;0.0
FR;2021-02-25;100546;94294;0;0;2980632;1556562;0;0;4.4;2.3;0.0;0.0
FR;2021-02-26;113433;73765;0;0;3094065;1630327;0;0;4.6;2.4;0.0;0.0
FR;2021-02-27;52091;23358;0;0;3146156;1653685;0;0;4.7;2.5;0.0;0.0
FR;2021-02-28;6193;4450;0;0;3152349;1658135;0;0;4.7;2.5;0.0;0.0
FR;2021-03-01;65841;55064;0;0;3218190;1713199;0;0;4.8;2.6;0.0;0.0
FR;2021-03-02;101352;69594;0;0;3319542;1782793;0;0;4.9;2.7;0.0;0.0
FR;2021-03-03;116475;69136;0;0;3436017;1851929;0;0;5.1;2.8;0.0;0.0
FR;2021-03-04;163593;75864;0;0;3599610;1927793;0;0;5.4;2.9;0.0;0.0
FR;2021-03-05;200888;69695;0;0;3800498;1997488;0;0;5.7;3.0;0.0;0.0
FR;2021-03-06;207930;23011;0;0;4008428;2020499;0;0;6.0;3.0;0.0;0.0
FR;2021-03-07;121252;8248;0;0;4129680;2028747;0;0;6.2;3.0;0.0;0.0
FR;2021-03-08;107119;53701;0;0;4236799;2082448;0;0;6.3;3.1;0.0;0.0
FR;2021-03-09;172423;61868;0;0;4409222;2144316;0;0;6.6;3.2;0.0;0.0
FR;2021-03-10;178945;62705;0;0;4588167;2207021;0;0;6.8;3.3;0.0;0.0
FR;2021-03-11;242835;71578;0;0;4831002;2278599;0;0;7.2;3.4;0.0;0.0
FR;2021-03-12;294783;62770;0;0;5125785;2341369;0;0;7.6;3.5;0.0;0.0
FR;2021-03-13;231375;21307;0;0;5357160;2362676;0;0;8.0;3.5;0.0;0.0
FR;2021-03-14;63340;5300;0;0;5420500;2367976;0;0;8.1;3.5;0.0;0.0
FR;2021-03-15;158609;36762;0;0;5579109;2404738;0;0;8.3;3.6;0.0;0.0
FR;2021-03-16;141542;43184;0;0;5720651;2447922;0;0;8.5;3.6;0.0;0.0
FR;2021-03-17;150450;42931;0;0;5871101;2490853;0;0;8.7;3.7;0.0;0.0
FR;2021-03-18;167791;50041;0;0;6038892;2540894;0;0;9.0;3.8;0.0;0.0
FR;2021-03-19;229970;44484;0;0;6268862;2585378;0;0;9.3;3.9;0.0;0.0
FR;2021-03-20;166647;16183;0;0;6435509;2601561;0;0;9.6;3.9;0.0;0.0
FR;2021-03-21;49921;4251;0;0;6485430;2605812;0;0;9.7;3.9;0.0;0.0
FR;2021-03-22;169999;39426;0;0;6655429;2645238;0;0;9.9;3.9;0.0;0.0
FR;2021-03-23;250332;50168;0;0;6905761;2695406;0;0;10.3;4.0;0.0;0.0
FR;2021-03-24;256864;51684;0;0;7162625;2747090;0;0;10.7;4.1;0.0;0.0
FR;2021-03-25;341761;55805;0;0;7504386;2802895;0;0;11.2;4.2;0.0;0.0
FR;2021-03-26;358755;53609;0;0;7863141;2856504;0;0;11.7;4.3;0.0;0.0
FR;2021-03-27;195241;23167;0;0;8058382;2879671;0;0;12.0;4.3;0.0;0.0
FR;2021-03-28;59324;6097;0;0;8117706;2885768;0;0;12.1;4.3;0.0;0.0
FR;2021-03-29;202936;60641;0;0;8320642;2946409;0;0;12.4;4.4;0.0;0.0
FR;2021-03-30;285435;79985;0;0;8606077;3026394;0;0;12.8;4.5;0.0;0.0
FR;2021-03-31;262972;83885;0;0;8869049;3110279;0;0;13.2;4.6;0.0;0.0
FR;2021-04-01;315400;102940;0;0;9184449;3213219;0;0;13.7;4.8;0.0;0.0
FR;2021-04-02;281288;104580;0;0;9465737;3317799;0;0;14.1;4.9;0.0;0.0
FR;2021-04-03;141052;67189;0;0;9606789;3384988;0;0;14.3;5.0;0.0;0.0
FR;2021-04-04;46472;20776;0;0;9653261;3405764;0;0;14.4;5.1;0.0;0.0
FR;2021-04-05;63310;13431;0;0;9716571;3419195;0;0;14.5;5.1;0.0;0.0
FR;2021-04-06;217156;118167;0;0;9933727;3537362;0;0;14.8;5.3;0.0;0.0
FR;2021-04-07;260206;126628;0;0;10193933;3663990;0;0;15.2;5.5;0.0;0.0
FR;2021-04-08;337746;137333;0;0;10531679;3801323;0;0;15.7;5.7;0.0;0.0
FR;2021-04-09;410083;133655;0;0;10941762;3934978;0;0;16.3;5.9;0.0;0.0
FR;2021-04-10;212588;90967;0;0;11154350;4025945;0;0;16.6;6.0;0.0;0.0
FR;2021-04-11;56123;36929;0;0;11210473;4062874;0;0;16.7;6.1;0.0;0.0
FR;2021-04-12;237010;124742;0;0;11447483;4187616;0;0;17.1;6.2;0.0;0.0
FR;2021-04-13;309428;157328;0;0;11756911;4344944;0;0;17.5;6.5;0.0;0.0
FR;2021-04-14;294449;152599;0;0;12051360;4497543;0;0;18.0;6.7;0.0;0.0
FR;2021-04-15;337025;163884;0;0;12388385;4661427;0;0;18.5;6.9;0.0;0.0
FR;2021-04-16;339228;160518;0;0;12727613;4821945;0;0;19.0;7.2;0.0;0.0
FR;2021-04-17;188629;97647;0;0;12916242;4919592;0;0;19.2;7.3;0.0;0.0
FR;2021-04-18;51604;37770;0;0;12967846;4957362;0;0;19.3;7.4;0.0;0.0
FR;2021-04-19;205647;147257;0;0;13173493;5104619;0;0;19.6;7.6;0.0;0.0
FR;2021-04-20;254356;182492;0;0;13427849;5287111;0;0;20.0;7.9;0.0;0.0
FR;2021-04-21;253184;181105;0;0;13681033;5468216;0;0;20.4;8.1;0.0;0.0
FR;2021-04-22;287498;203380;0;0;13968531;5671596;0;0;20.8;8.5;0.0;0.0
FR;2021-04-23;297924;202460;0;0;14266455;5874056;0;0;21.3;8.8;0.0;0.0
FR;2021-04-24;190414;121987;0;0;14456869;5996043;0;0;21.5;8.9;0.0;0.0
FR;2021-04-25;69541;42507;0;0;14526410;6038550;0;0;21.6;9.0;0.0;0.0
FR;2021-04-26;220898;169500;0;0;14747308;6208050;0;0;22.0;9.2;0.0;0.0
FR;2021-04-27;284554;210642;0;0;15031862;6418692;0;0;22.4;9.6;0.0;0.0
FR;2021-04-28;299448;208326;1;0;15331310;6627018;1;0;22.8;9.9;0.0;0.0
FR;2021-04-29;357066;231658;0;0;15688376;6858676;1;0;23.4;10.2;0.0;0.0
FR;2021-04-30;372147;224173;0;0;16060523;7082849;1;0;23.9;10.6;0.0;0.0
FR;2021-05-01;167611;63714;0;0;16228134;7146563;1;0;24.2;10.6;0.0;0.0
FR;2021-05-02;91708;43465;0;0;16319842;7190028;1;0;24.3;10.7;0.0;0.0
FR;2021-05-03;288864;188725;0;0;16608706;7378753;1;0;24.7;11.0;0.0;0.0
FR;2021-05-04;315604;250514;0;0;16924310;7629267;1;0;25.2;11.4;0.0;0.0
FR;2021-05-05;327117;249812;0;0;17251427;7879079;1;0;25.7;11.7;0.0;0.0
FR;2021-05-06;379438;273719;0;0;17630865;8152798;1;0;26.3;12.1;0.0;0.0
FR;2021-05-07;372689;298320;0;0;18003554;8451118;1;0;26.8;12.6;0.0;0.0
FR;2021-05-08;222137;82799;0;0;18225691;8533917;1;0;27.2;12.7;0.0;0.0
FR;2021-05-09;129685;54924;0;0;18355376;8588841;1;0;27.3;12.8;0.0;0.0
FR;2021-05-10;313317;254496;0;0;18668693;8843337;1;0;27.8;13.2;0.0;0.0
FR;2021-05-11;403832;296176;0;0;19072525;9139513;1;0;28.4;13.6;0.0;0.0
FR;2021-05-12;434038;269333;0;0;19506563;9408846;1;0;29.1;14.0;0.0;0.0
FR;2021-05-13;338553;78390;0;0;19845116;9487236;1;0;29.6;14.1;0.0;0.0
FR;2021-05-14;454058;202786;0;0;20299174;9690022;1;0;30.2;14.4;0.0;0.0
FR;2021-05-15;374924;120423;0;0;20674098;9810445;1;0;30.8;14.6;0.0;0.0
FR;2021-05-16;202726;34157;0;0;20876824;9844602;1;0;31.1;14.7;0.0;0.0
FR;2021-05-17;376073;178564;0;0;21252897;10023166;1;0;31.7;14.9;0.0;0.0
FR;2021-05-18;460075;192305;0;0;21712972;10215471;1;0;32.4;15.2;0.0;0.0
FR;2021-05-19;467327;181820;0;0;22180299;10397291;1;0;33.0;15.5;0.0;0.0
FR;2021-05-20;507466;204198;0;0;22687765;10601489;1;0;33.8;15.8;0.0;0.0
FR;2021-05-21;489602;220926;0;0;23177367;10822415;1;0;34.5;16.1;0.0;0.0
FR;2021-05-22;347147;108310;0;0;23524514;10930725;1;0;35.1;16.3;0.0;0.0
FR;2021-05-23;161671;26850;0;0;23686185;10957575;1;0;35.3;16.3;0.0;0.0
FR;2021-05-24;263156;53017;0;0;23949341;11010592;1;0;35.7;16.4;0.0;0.0
FR;2021-05-25;400203;225777;0;0;24349544;11236369;1;0;36.3;16.7;0.0;0.0
FR;2021-05-26;413400;226655;0;0;24762944;11463024;1;0;36.9;17.1;0.0;0.0
FR;2021-05-27;449750;265871;0;0;25212694;11728895;1;0;37.6;17.5;0.0;0.0
FR;2021-05-28;429497;317545;0;0;25642191;12046440;1;0;38.2;17.9;0.0;0.0
FR;2021-05-29;298950;182228;0;0;25941141;12228668;1;0;38.7;18.2;0.0;0.0
FR;2021-05-30;107123;42156;0;0;26048264;12270824;1;0;38.8;18.3;0.0;0.0
FR;2021-05-31;357984;241556;1;0;26406248;12512380;2;0;39.3;18.6;0.0;0.0
FR;2021-06-01;430898;302744;1;0;26837146;12815124;3;0;40.0;19.1;0.0;0.0
FR;2021-06-02;419535;278199;0;0;27256681;13093323;3;0;40.6;19.5;0.0;0.0
FR;2021-06-03;464932;313052;0;0;27721613;13406375;3;0;41.3;20.0;0.0;0.0
FR;2021-06-04;455781;361981;1;0;28177394;13768356;4;0;42.0;20.5;0.0;0.0
FR;2021-06-05;304760;222163;0;0;28482154;13990519;4;0;42.4;20.8;0.0;0.0
FR;2021-06-06;133250;61249;0;0;28615404;14051768;4;0;42.6;20.9;0.0;0.0
FR;2021-06-07;339131;298925;0;0;28954535;14350693;4;0;43.1;21.4;0.0;0.0
FR;2021-06-08;393610;337695;0;0;29348145;14688388;4;0;43.7;21.9;0.0;0.0
FR;2021-06-09;384707;319710;0;0;29732852;15008098;4;0;44.3;22.4;0.0;0.0
FR;2021-06-10;404024;338132;0;0;30136876;15346230;4;0;44.9;22.9;0.0;0.0
FR;2021-06-11;386535;407452;0;0;30523411;15753682;4;0;45.5;23.5;0.0;0.0
FR;2021-06-12;283213;243381;0;0;30806624;15997063;4;0;45.9;23.8;0.0;0.0
FR;2021-06-13;104840;84973;0;0;30911464;16082036;4;0;46.1;24.0;0.0;0.0
FR;2021-06-14;240662;384503;0;0;31152126;16466539;4;0;46.4;24.5;0.0;0.0
FR;2021-06-15;308003;424214;0;0;31460129;16890753;4;0;46.9;25.2;0.0;0.0
FR;2021-06-16;313854;395479;0;0;31773983;17286232;4;0;47.3;25.8;0.0;0.0
FR;2021-06-17;317567;413606;0;0;32091550;17699838;4;0;47.8;26.4;0.0;0.0
FR;2021-06-18;321564;485766;0;0;32413114;18185604;4;0;48.3;27.1;0.0;0.0
FR;2021-06-19;224309;300942;0;0;32637423;18486546;4;0;48.6;27.5;0.0;0.0
FR;2021-06-20;74374;111766;0;0;32711797;18598312;4;0;48.7;27.7;0.0;0.0
FR;2021-06-21;195576;427767;1;0;32907373;19026079;5;0;49.0;28.3;0.0;0.0
FR;2021-06-22;223016;499994;2;0;33130389;19526073;7;0;49.4;29.1;0.0;0.0
FR;2021-06-23;233879;474016;1;0;33364268;20000089;8;0;49.7;29.8;0.0;0.0
FR;2021-06-24;241739;447083;0;0;33606007;20447172;8;0;50.1;30.5;0.0;0.0
FR;2021-06-25;227483;561219;0;0;33833490;21008391;8;0;50.4;31.3;0.0;0.0
FR;2021-06-26;153195;395518;0;0;33986685;21403909;8;0;50.6;31.9;0.0;0.0
FR;2021-06-27;55865;165107;0;0;34042550;21569016;8;0;50.7;32.1;0.0;0.0
FR;2021-06-28;154625;478411;0;0;34197175;22047427;8;0;51.0;32.9;0.0;0.0
FR;2021-06-29;182551;538335;0;0;34379726;22585762;8;0;51.2;33.7;0.0;0.0
FR;2021-06-30;203852;517215;2;0;34583578;23102977;10;0;51.5;34.4;0.0;0.0
FR;2021-07-01;231135;497944;1;0;34814713;23600921;11;0;51.9;35.2;0.0;0.0
FR;2021-07-02;228376;562670;3;0;35043089;24163591;14;0;52.2;36.0;0.0;0.0
FR;2021-07-03;141947;395292;1;0;35185036;24558883;15;0;52.4;36.6;0.0;0.0
FR;2021-07-04;56694;150959;0;0;35241730;24709842;15;0;52.5;36.8;0.0;0.0
FR;2021-07-05;168250;449334;2;0;35409980;25159176;17;0;52.8;37.5;0.0;0.0
FR;2021-07-06;196594;511510;8;0;35606574;25670686;25;0;53.1;38.2;0.0;0.0
FR;2021-07-07;212979;477917;5;0;35819553;26148603;30;0;53.4;39.0;0.0;0.0
FR;2021-07-08;231462;468298;7;0;36051015;26616901;37;0;53.7;39.7;0.0;0.0
FR;2021-07-09;228361;557249;2;0;36279376;27174150;39;0;54.1;40.5;0.0;0.0
FR;2021-07-10;148538;368911;1;0;36427914;27543061;40;0;54.3;41.0;0.0;0.0
FR;2021-07-11;60143;121097;0;0;36488057;27664158;40;0;54.4;41.2;0.0;0.0
FR;2021-07-12;168976;513131;0;0;36657033;28177289;40;0;54.6;42.0;0.0;0.0
FR;2021-07-13;287081;586676;2;0;36944114;28763965;42;0;55.0;42.9;0.0;0.0
FR;2021-07-14;180909;187105;0;0;37125023;28951070;42;0;55.3;43.1;0.0;0.0
FR;2021-07-15;346898;572719;0;0;37471921;29523789;42;0;55.8;44.0;0.0;0.0
FR;2021-07-16;379922;575349;1;0;37851843;30099138;43;0;56.4;44.8;0.0;0.0
FR;2021-07-17;259656;368921;0;0;38111499;30468059;43;0;56.8;45.4;0.0;0.0
FR;2021-07-18;109668;133280;0;0;38221167;30601339;43;0;56.9;45.6;0.0;0.0
FR;2021-07-19;285330;480167;0;0;38506497;31081506;43;0;57.4;46.3;0.0;0.0
FR;2021-07-20;376746;524861;0;0;38883243;31606367;43;0;57.9;47.1;0.0;0.0
FR;2021-07-21;395641;483059;2;0;39278884;32089426;45;0;58.5;47.8;0.0;0.0
FR;2021-07-22;440901;472767;2;0;39719785;32562193;47;0;59.2;48.5;0.0;0.0
FR;2021-07-23;440157;511297;2;0;40159942;33073490;49;0;59.8;49.3;0.0;0.0
FR;2021-07-24;285187;322347;0;0;40445129;33395837;49;0;60.3;49.8;0.0;0.0
FR;2021-07-25;121059;100453;0;0;40566188;33496290;49;0;60.4;49.9;0.0;0.0
FR;2021-07-26;347282;385875;2;0;40913470;33882165;51;0;61.0;50.5;0.0;0.0
FR;2021-07-27;463911;401621;2;0;41377381;34283786;53;0;61.7;51.1;0.0;0.0
FR;2021-07-28;459315;367830;2;0;41836696;34651616;55;0;62.3;51.6;0.0;0.0
FR;2021-07-29;489692;358031;1;0;42326388;35009647;56;0;63.1;52.2;0.0;0.0
FR;2021-07-30;461650;381592;2;0;42788038;35391239;58;0;63.8;52.7;0.0;0.0
FR;2021-07-31;285348;231698;0;0;43073386;35622937;58;0;64.2;53.1;0.0;0.0
FR;2021-08-01;111943;65819;0;0;43185329;35688756;58;0;64.3;53.2;0.0;0.0
FR;2021-08-02;341246;285527;0;0;43526575;35974283;58;0;64.9;53.6;0.0;0.0
FR;2021-08-03;398433;305367;1;0;43925008;36279650;59;0;65.4;54.1;0.0;0.0
FR;2021-08-04;384672;266470;3;0;44309680;36546120;62;0;66.0;54.5;0.0;0.0
FR;2021-08-05;365997;282565;0;0;44675677;36828685;62;0;66.6;54.9;0.0;0.0
FR;2021-08-06;359588;327313;1;0;45035265;37155998;63;0;67.1;55.4;0.0;0.0
FR;2021-08-07;213046;210241;3;0;45248311;37366239;66;0;67.4;55.7;0.0;0.0
FR;2021-08-08;74138;73715;0;0;45322449;37439954;66;0;67.5;55.8;0.0;0.0
FR;2021-08-09;258595;298610;3;0;45581044;37738564;69;0;67.9;56.2;0.0;0.0
FR;2021-08-10;306622;324627;1;0;45887666;38063191;70;0;68.4;56.7;0.0;0.0
FR;2021-08-11;279558;302562;1;0;46167224;38365753;71;0;68.8;57.2;0.0;0.0
FR;2021-08-12;271402;321200;1;0;46438626;38686953;72;0;69.2;57.6;0.0;0.0
FR;2021-08-13;252048;317054;2;0;46690674;39004007;74;0;69.6;58.1;0.0;0.0
FR;2021-08-14;145286;219389;0;0;46835960;39223396;74;0;69.8;58.4;0.0;0.0
FR;2021-08-15;39310;55732;0;0;46875270;39279128;74;0;69.8;58.5;0.0;0.0
FR;2021-08-16;186052;346277;0;0;47061322;39625405;74;0;70.1;59.0;0.0;0.0
FR;2021-08-17;215567;369856;1;0;47276889;39995261;75;0;70.4;59.6;0.0;0.0
FR;2021-08-18;198955;355218;4;0;47475844;40350479;79;0;70.7;60.1;0.0;0.0
FR;2021-08-19;191908;356643;0;0;47667752;40707122;79;0;71.0;60.7;0.0;0.0
FR;2021-08-20;186369;397237;2;0;47854121;41104359;81;0;71.3;61.2;0.0;0.0
FR;2021-08-21;104763;254740;0;0;47958884;41359099;81;0;71.5;61.6;0.0;0.0
FR;2021-08-22;31892;92205;1;0;47990776;41451304;82;0;71.5;61.8;0.0;0.0
FR;2021-08-23;140904;380188;1;0;48131680;41831492;83;0;71.7;62.3;0.0;0.0
FR;2021-08-24;162410;403553;1;0;48294090;42235045;84;0;72.0;62.9;0.0;0.0
FR;2021-08-25;151068;376026;3;0;48445158;42611071;87;0;72.2;63.5;0.0;0.0
FR;2021-08-26;142766;368327;1;0;48587924;42979398;88;0;72.4;64.0;0.0;0.0
FR;2021-08-27;148373;415663;3;0;48736297;43395061;91;0;72.6;64.7;0.0;0.0
FR;2021-08-28;90613;265280;0;0;48826910;43660341;91;0;72.8;65.1;0.0;0.0
FR;2021-08-29;27304;88388;0;0;48854214;43748729;91;0;72.8;65.2;0.0;0.0
FR;2021-08-30;117336;342642;6016;0;48971550;44091371;6107;0;73.0;65.7;0.0;0.0
FR;2021-08-31;128719;354183;11864;2;49100269;44445554;17971;2;73.2;66.2;0.0;0.0
FR;2021-09-01;135807;302696;24318;1;49236076;44748250;42289;3;73.4;66.7;0.1;0.0
FR;2021-09-02;112670;262465;28883;1;49348746;45010715;71172;4;73.5;67.1;0.1;0.0
FR;2021-09-03;118218;309684;32968;5;49466964;45320399;104140;9;73.7;67.5;0.2;0.0
FR;2021-09-04;89825;230649;14083;5;49556789;45551048;118223;14;73.8;67.9;0.2;0.0
FR;2021-09-05;21344;48353;4733;0;49578133;45599401;122956;14;73.9;67.9;0.2;0.0
FR;2021-09-06;75344;191178;34236;2;49653477;45790579;157192;16;74.0;68.2;0.2;0.0
FR;2021-09-07;80132;191472;36120;3;49733609;45982051;193312;19;74.1;68.5;0.3;0.0
FR;2021-09-08;89944;216928;32460;6;49823553;46198979;225772;25;74.2;68.8;0.3;0.0
FR;2021-09-09;76709;174512;36532;16;49900262;46373491;262304;41;74.4;69.1;0.4;0.0
FR;2021-09-10;95683;215249;40523;12;49995945;46588740;302827;53;74.5;69.4;0.5;0.0
FR;2021-09-11;66860;178295;14319;1;50062805;46767035;317146;54;74.6;69.7;0.5;0.0
FR;2021-09-12;12799;34161;3159;2;50075604;46801196;320305;56;74.6;69.7;0.5;0.0
FR;2021-09-13;64383;134634;44074;29;50139987;46935830;364379;85;74.7;69.9;0.5;0.0
FR;2021-09-14;73344;136270;62081;53;50213331;47072100;426460;138;74.8;70.1;0.6;0.0
FR;2021-09-15;76431;174889;54775;99;50289762;47246989;481235;237;74.9;70.4;0.7;0.0
FR;2021-09-16;63776;118003;60033;124;50353538;47364992;541268;361;75.0;70.6;0.8;0.0
FR;2021-09-17;74993;159819;57243;88;50428531;47524811;598511;449;75.1;70.8;0.9;0.0
FR;2021-09-18;48195;144336;17285;24;50476726;47669147;615796;473;75.2;71.0;0.9;0.0
FR;2021-09-19;7868;24931;2620;3;50484594;47694078;618416;476;75.2;71.1;0.9;0.0
FR;2021-09-20;44457;96441;50260;55;50529051;47790519;668676;531;75.3;71.2;1.0;0.0
FR;2021-09-21;45817;98510;63391;124;50574868;47889029;732067;655;75.4;71.4;1.1;0.0
FR;2021-09-22;48622;144841;55357;66;50623490;48033870;787424;721;75.4;71.6;1.2;0.0
FR;2021-09-23;43172;91276;63477;117;50666662;48125146;850901;838;75.5;71.7;1.3;0.0
FR;2021-09-24;52235;132509;59105;102;50718897;48257655;910006;940;75.6;71.9;1.4;0.0
FR;2021-09-25;35194;118575;18256;27;50754091;48376230;928262;967;75.6;72.1;1.4;0.0
FR;2021-09-26;5527;18680;2326;5;50759618;48394910;930588;972;75.6;72.1;1.4;0.0
FR;2021-09-27;33927;78875;48134;112;50793545;48473785;978722;1084;75.7;72.2;1.5;0.0
FR;2021-09-28;36457;74401;56494;78;50830002;48548186;1035216;1162;75.7;72.3;1.5;0.0
FR;2021-09-29;44321;103018;54815;73;50874323;48651204;1090031;1235;75.8;72.5;1.6;0.0
FR;2021-09-30;36276;71438;59486;85;50910599;48722642;1149517;1320;75.9;72.6;1.7;0.0
FR;2021-10-01;61543;99749;63707;53;50972142;48822391;1213224;1373;75.9;72.7;1.8;0.0
FR;2021-10-02;39424;81712;23320;18;51011566;48904103;1236544;1391;76.0;72.9;1.8;0.0
FR;2021-10-03;5270;11291;2538;4;51016836;48915394;1239082;1395;76.0;72.9;1.8;0.0
FR;2021-10-04;34994;59587;54784;82;51051830;48974981;1293866;1477;76.1;73.0;1.9;0.0
FR;2021-10-05;33622;62194;64936;67;51085452;49037175;1358802;1544;76.1;73.1;2.0;0.0
FR;2021-10-06;42504;80240;68227;42;51127956;49117415;1427029;1586;76.2;73.2;2.1;0.0
FR;2021-10-07;30435;59498;68671;87;51158391;49176913;1495700;1673;76.2;73.3;2.2;0.0
FR;2021-10-08;48769;89907;84620;67;51207160;49266820;1580320;1740;76.3;73.4;2.4;0.0
FR;2021-10-09;33632;64153;33869;20;51240792;49330973;1614189;1760;76.3;73.5;2.4;0.0
FR;2021-10-10;4644;7942;3482;2;51245436;49338915;1617671;1762;76.4;73.5;2.4;0.0
FR;2021-10-11;30577;50644;64018;93;51276013;49389559;1681689;1855;76.4;73.6;2.5;0.0
FR;2021-10-12;31429;51404;75837;54;51307442;49440963;1757526;1909;76.4;73.7;2.6;0.0
FR;2021-10-13;40015;62846;79256;50;51347457;49503809;1836782;1959;76.5;73.8;2.7;0.0
FR;2021-10-14;30244;49774;73765;49;51377701;49553583;1910547;2008;76.6;73.8;2.8;0.0
FR;2021-10-15;44748;70472;102902;57;51422449;49624055;2013449;2065;76.6;73.9;3.0;0.0
FR;2021-10-16;31280;46725;39615;23;51453729;49670780;2053064;2088;76.7;74.0;3.1;0.0
FR;2021-10-17;3830;5695;3692;3;51457559;49676475;2056756;2091;76.7;74.0;3.1;0.0
FR;2021-10-18;28419;42674;71336;36;51485978;49719149;2128092;2127;76.7;74.1;3.2;0.0
FR;2021-10-19;27061;42347;81605;70;51513039;49761496;2209697;2197;76.8;74.1;3.3;0.0
FR;2021-10-20;35215;51906;101475;90;51548254;49813402;2311172;2287;76.8;74.2;3.4;0.0
FR;2021-10-21;25977;42014;89103;45;51574231;49855416;2400275;2332;76.8;74.3;3.6;0.0
FR;2021-10-22;38219;59346;112498;90;51612450;49914762;2512773;2422;76.9;74.4;3.7;0.0
FR;2021-10-23;26976;42463;48602;23;51639426;49957225;2561375;2445;76.9;74.4;3.8;0.0
FR;2021-10-24;2913;5023;3937;1;51642339;49962248;2565312;2446;76.9;74.4;3.8;0.0
FR;2021-10-25;25983;35633;86603;66;51668322;49997881;2651915;2512;77.0;74.5;4.0;0.0
FR;2021-10-26;23687;32312;92314;47;51692009;50030193;2744229;2559;77.0;74.5;4.1;0.0
FR;2021-10-27;30023;44202;114627;71;51722032;50074395;2858856;2630;77.1;74.6;4.3;0.0
FR;2021-10-28;23448;31217;94394;58;51745480;50105612;2953250;2688;77.1;74.7;4.4;0.0
FR;2021-10-29;31520;46551;125259;77;51777000;50152163;3078509;2765;77.1;74.7;4.6;0.0
FR;2021-10-30;20536;32889;53356;26;51797536;50185052;3131865;2791;77.2;74.8;4.7;0.0
FR;2021-10-31;2480;3866;3870;3;51800016;50188918;3135735;2794;77.2;74.8;4.7;0.0
FR;2021-11-01;8236;4972;3557;10;51808252;50193890;3139292;2804;77.2;74.8;4.7;0.0
FR;2021-11-02;25337;36349;99483;62;51833589;50230239;3238775;2866;77.2;74.8;4.8;0.0
FR;2021-11-03;29798;43625;125791;94;51863387;50273864;3364566;2960;77.3;74.9;5.0;0.0
FR;2021-11-04;23683;31650;114335;65;51887070;50305514;3478901;3025;77.3;75.0;5.2;0.0
FR;2021-11-05;32298;44718;151264;85;51919368;50350232;3630165;3110;77.4;75.0;5.4;0.0
FR;2021-11-06;21496;32456;68235;36;51940864;50382688;3698400;3146;77.4;75.1;5.5;0.0
FR;2021-11-07;2380;4042;5589;8;51943244;50386730;3703989;3154;77.4;75.1;5.5;0.0
FR;2021-11-08;20451;31090;134191;72;51963695;50417820;3838180;3226;77.4;75.1;5.7;0.0
FR;2021-11-09;22186;33090;172137;103;51985881;50450910;4010317;3329;77.5;75.2;6.0;0.0
FR;2021-11-10;31418;44301;198693;124;52017299;50495211;4209010;3453;77.5;75.2;6.3;0.0
FR;2021-11-11;4367;5877;13932;19;52021666;50501088;4222942;3472;77.5;75.2;6.3;0.0
FR;2021-11-12;29001;41868;197271;127;52050667;50542956;4420213;3599;77.6;75.3;6.6;0.0
FR;2021-11-13;20311;28355;86292;57;52070978;50571311;4506505;3656;77.6;75.4;6.7;0.0
FR;2021-11-14;2337;3402;7871;10;52073315;50574713;4514376;3666;77.6;75.4;6.7;0.0
FR;2021-11-15;20357;28056;171466;101;52093672;50602769;4685842;3767;77.6;75.4;7.0;0.0
FR;2021-11-16;23416;28009;214890;151;52117088;50630778;4900732;3918;77.7;75.4;7.3;0.0
FR;2021-11-17;30377;36697;212793;131;52147465;50667475;5113525;4049;77.7;75.5;7.6;0.0
FR;2021-11-18;23366;28931;205411;122;52170831;50696406;5318936;4171;77.7;75.5;7.9;0.0
FR;2021-11-19;33562;40071;262075;183;52204393;50736477;5581011;4354;77.8;75.6;8.3;0.0
FR;2021-11-20;25357;29402;109671;62;52229750;50765879;5690682;4416;77.8;75.6;8.5;0.0
FR;2021-11-21;2623;3482;10639;17;52232373;50769361;5701321;4433;77.8;75.6;8.5;0.0
FR;2021-11-22;22743;19185;194760;85;52255116;50788546;5896081;4518;77.9;75.7;8.8;0.0
FR;2021-11-23;25576;24445;247735;82;52280692;50812991;6143816;4600;77.9;75.7;9.2;0.0
FR;2021-11-24;31771;34783;243147;80;52312463;50847774;6386963;4680;77.9;75.8;9.5;0.0
FR;2021-11-25;25416;25206;277604;111;52337879;50872980;6664567;4791;78.0;75.8;9.9;0.0
FR;2021-11-26;33217;37565;414514;161;52371096;50910545;7079081;4952;78.0;75.9;10.5;0.0
FR;2021-11-27;23339;28663;236585;147;52394435;50939208;7315666;5099;78.1;75.9;10.9;0.0
FR;2021-11-28;3480;4121;63341;41;52397915;50943329;7379007;5140;78.1;75.9;11.0;0.0
FR;2021-11-29;19390;23446;371568;176;52417305;50966775;7750575;5316;78.1;75.9;11.5;0.0
FR;2021-11-30;24734;27229;500655;282;52442039;50994004;8251230;5598;78.1;76.0;12.3;0.0
FR;2021-12-01;26936;31858;511195;300;52468975;51025862;8762425;5898;78.2;76.0;13.1;0.0
FR;2021-12-02;22009;21437;574716;303;52490984;51047299;9337141;6201;78.2;76.1;13.9;0.0
FR;2021-12-03;25498;34163;651001;327;52516482;51081462;9988142;6528;78.2;76.1;14.9;0.0
FR;2021-12-04;18298;25913;369704;214;52534780;51107375;10357846;6742;78.3;76.1;15.4;0.0
FR;2021-12-05;4142;4951;107052;94;52538922;51112326;10464898;6836;78.3;76.2;15.6;0.0
FR;2021-12-06;24166;25740;539853;383;52563088;51138066;11004751;7219;78.3;76.2;16.4;0.0
FR;2021-12-07;23338;29169;706189;407;52586426;51167235;11710940;7626;78.4;76.2;17.4;0.0
FR;2021-12-08;25358;35479;647376;437;52611784;51202714;12358316;8063;78.4;76.3;18.4;0.0
FR;2021-12-09;24005;29499;726218;455;52635789;51232213;13084534;8518;78.4;76.3;19.5;0.0
FR;2021-12-10;27854;38373;805984;463;52663643;51270586;13890518;8981;78.5;76.4;20.7;0.0
FR;2021-12-11;20225;29979;480330;351;52683868;51300565;14370848;9332;78.5;76.4;21.4;0.0
FR;2021-12-12;5625;6480;159218;107;52689493;51307045;14530066;9439;78.5;76.4;21.6;0.0
FR;2021-12-13;21205;30203;649183;393;52710698;51337248;15179249;9832;78.5;76.5;22.6;0.0
FR;2021-12-14;27661;35877;847369;690;52738359;51373125;16026618;10522;78.6;76.5;23.9;0.0
FR;2021-12-15;28261;39964;768924;491;52766620;51413089;16795542;11013;78.6;76.6;25.0;0.0
FR;2021-12-16;27957;35623;844271;504;52794577;51448712;17639813;11517;78.7;76.7;26.3;0.0
FR;2021-12-17;31578;43787;891998;593;52826155;51492499;18531811;12110;78.7;76.7;27.6;0.0
FR;2021-12-18;24918;30268;522158;365;52851073;51522767;19053969;12475;78.7;76.8;28.4;0.0
FR;2021-12-19;8745;7965;191135;140;52859818;51530732;19245104;12615;78.8;76.8;28.7;0.0
FR;2021-12-20;31650;34282;658630;489;52891468;51565014;19903734;13104;78.8;76.8;29.7;0.0
FR;2021-12-21;39233;39266;759467;579;52930701;51604280;20663201;13683;78.9;76.9;30.8;0.0
FR;2021-12-22;39476;37506;642052;702;52970177;51641786;21305253;14385;78.9;76.9;31.7;0.0
FR;2021-12-23;33750;30414;494321;592;53003927;51672200;21799574;14977;79.0;77.0;32.5;0.0
FR;2021-12-24;10667;11631;126642;240;53014594;51683831;21926216;15217;79.0;77.0;32.7;0.0
FR;2021-12-25;770;1953;9029;72;53015364;51685784;21935245;15289;79.0;77.0;32.7;0.0
FR;2021-12-26;4698;4760;60131;169;53020062;51690544;21995376;15458;79.0;77.0;32.8;0.0
FR;2021-12-27;30416;33187;509081;673;53050478;51723731;22504457;16131;79.0;77.1;33.5;0.0
FR;2021-12-28;38323;35349;632173;1554;53088801;51759080;23136630;17685;79.1;77.1;34.5;0.0
FR;2021-12-29;39849;33291;560930;1753;53128650;51792371;23697560;19438;79.2;77.2;35.3;0.0
FR;2021-12-30;35893;29511;471107;1879;53164543;51821882;24168667;21317;79.2;77.2;36.0;0.0
FR;2021-12-31;12039;11357;131622;754;53176582;51833239;24300289;22071;79.2;77.2;36.2;0.0
FR;2022-01-01;1426;1772;9931;100;53178008;51835011;24310220;22171;79.2;77.2;36.2;0.0
FR;2022-01-02;6089;5092;66942;408;53184097;51840103;24377162;22579;79.2;77.2;36.3;0.0
FR;2022-01-03;33519;36745;551513;2644;53217616;51876848;24928675;25223;79.3;77.3;37.1;0.0
FR;2022-01-04;41193;40592;714251;3839;53258809;51917440;25642926;29062;79.4;77.4;38.2;0.0
FR;2022-01-05;60505;43515;634078;3437;53319314;51960955;26277004;32499;79.4;77.4;39.2;0.0
FR;2022-01-06;44099;40101;711350;4566;53363413;52001056;26988354;37065;79.5;77.5;40.2;0.1
FR;2022-01-07;50699;46676;790357;5003;53414112;52047732;27778711;42068;79.6;77.6;41.4;0.1
FR;2022-01-08;44971;35025;472855;2444;53459083;52082757;28251566;44512;79.7;77.6;42.1;0.1
FR;2022-01-09;15597;11493;145688;830;53474680;52094250;28397254;45342;79.7;77.6;42.3;0.1
FR;2022-01-10;35166;39770;522303;3720;53509846;52134020;28919557;49062;79.7;77.7;43.1;0.1
FR;2022-01-11;41692;42257;608408;5216;53551538;52176277;29527965;54278;79.8;77.7;44.0;0.1
FR;2022-01-12;60214;49328;504231;4491;53611752;52225605;30032196;58769;79.9;77.8;44.7;0.1
FR;2022-01-13;38020;40397;540957;5461;53649772;52266002;30573153;64230;79.9;77.9;45.6;0.1
FR;2022-01-14;42442;43399;628961;6459;53692214;52309401;31202114;70689;80.0;77.9;46.5;0.1
FR;2022-01-15;39325;31335;377554;3292;53731539;52340736;31579668;73981;80.1;78.0;47.1;0.1
FR;2022-01-16;11385;9014;99448;760;53742924;52349750;31679116;74741;80.1;78.0;47.2;0.1
FR;2022-01-17;24634;28061;354132;3966;53767558;52377811;32033248;78707;80.1;78.0;47.7;0.1
FR;2022-01-18;28121;31849;397512;5771;53795679;52409660;32430760;84478;80.2;78.1;48.3;0.1
FR;2022-01-19;43098;40342;311062;4385;53838777;52450002;32741822;88863;80.2;78.1;48.8;0.1
FR;2022-01-20;23471;29430;328436;5628;53862248;52479432;33070258;94491;80.3;78.2;49.3;0.1
FR;2022-01-21;28060;33017;401128;6580;53890308;52512449;33471386;101071;80.3;78.2;49.9;0.2
FR;2022-01-22;27606;27284;241744;2842;53917914;52539733;33713130;103913;80.3;78.3;50.2;0.2
FR;2022-01-23;6705;7525;55174;590;53924619;52547258;33768304;104503;80.3;78.3;50.3;0.2
FR;2022-01-24;16211;25255;239321;4095;53940830;52572513;34007625;108598;80.4;78.3;50.7;0.2
FR;2022-01-25;18918;28785;267040;6064;53959748;52601298;34274665;114662;80.4;78.4;51.1;0.2
FR;2022-01-26;28122;41159;229362;4474;53987870;52642457;34504027;119136;80.4;78.4;51.4;0.2
FR;2022-01-27;16285;25870;225830;5695;54004155;52668327;34729857;124831;80.5;78.5;51.7;0.2
FR;2022-01-28;21503;42258;321444;7414;54025658;52710585;35051301;132245;80.5;78.5;52.2;0.2
FR;2022-01-29;18406;32687;204575;3249;54044064;52743272;35255876;135494;80.5;78.6;52.5;0.2
FR;2022-01-30;4464;9145;45085;639;54048528;52752417;35300961;136133;80.5;78.6;52.6;0.2
FR;2022-01-31;11226;25978;164788;4240;54059754;52778395;35465749;140373;80.5;78.6;52.8;0.2
FR;2022-02-01;12934;27149;191366;7099;54072688;52805544;35657115;147472;80.6;78.7;53.1;0.2
FR;2022-02-02;20134;45716;190131;5993;54092822;52851260;35847246;153465;80.6;78.7;53.4;0.2
FR;2022-02-03;11008;24719;173299;6968;54103830;52875979;36020545;160433;80.6;78.8;53.7;0.2
FR;2022-02-04;14525;35994;264164;9207;54118355;52911973;36284709;169640;80.6;78.8;54.1;0.3
FR;2022-02-05;12820;31922;172344;3818;54131175;52943895;36457053;173458;80.7;78.9;54.3;0.3
FR;2022-02-06;2706;7315;33825;664;54133881;52951210;36490878;174122;80.7;78.9;54.4;0.3
FR;2022-02-07;9411;24504;176323;5289;54143292;52975714;36667201;179411;80.7;78.9;54.6;0.3
FR;2022-02-08;9617;20634;184336;7051;54152909;52996348;36851537;186462;80.7;79.0;54.9;0.3
FR;2022-02-09;14188;35097;192975;5779;54167097;53031445;37044512;192241;80.7;79.0;55.2;0.3
FR;2022-02-10;8278;17976;166610;6498;54175375;53049421;37211122;198739;80.7;79.0;55.4;0.3
FR;2022-02-11;10771;25668;243021;8324;54186146;53075089;37454143;207063;80.7;79.1;55.8;0.3
FR;2022-02-12;8355;22564;151710;3502;54194501;53097653;37605853;210565;80.7;79.1;56.0;0.3
FR;2022-02-13;1896;4394;30907;543;54196397;53102047;37636760;211108;80.8;79.1;56.1;0.3
FR;2022-02-14;6914;14524;166316;4776;54203311;53116571;37803076;215884;80.8;79.1;56.3;0.3
FR;2022-02-15;6864;15338;162463;6846;54210175;53131909;37965539;222730;80.8;79.2;56.6;0.3
FR;2022-02-16;9306;25729;146683;5721;54219481;53157638;38112222;228451;80.8;79.2;56.8;0.3
FR;2022-02-17;5383;12781;94809;5403;54224864;53170419;38207031;233854;80.8;79.2;56.9;0.3
FR;2022-02-18;6923;18528;129265;7399;54231787;53188947;38336296;241253;80.8;79.3;57.1;0.4
FR;2022-02-19;5355;15828;77312;3017;54237142;53204775;38413608;244270;80.8;79.3;57.2;0.4
FR;2022-02-20;1138;2885;13926;459;54238280;53207660;38427534;244729;80.8;79.3;57.3;0.4
FR;2022-02-21;4029;10059;67144;4057;54242309;53217719;38494678;248786;80.8;79.3;57.4;0.4
FR;2022-02-22;4376;11126;64417;5249;54246685;53228845;38559095;254035;80.8;79.3;57.5;0.4
FR;2022-02-23;6520;19458;71867;4592;54253205;53248303;38630962;258627;80.8;79.3;57.6;0.4
FR;2022-02-24;3752;9186;53196;4530;54256957;53257489;38684158;263157;80.8;79.4;57.6;0.4
FR;2022-02-25;5211;14686;80009;7327;54262168;53272175;38764167;270484;80.8;79.4;57.8;0.4
FR;2022-02-26;3971;12078;51460;3084;54266139;53284253;38815627;273568;80.9;79.4;57.8;0.4
FR;2022-02-27;870;1958;8933;529;54267009;53286211;38824560;274097;80.9;79.4;57.8;0.4
FR;2022-02-28;3072;7334;42884;3849;54270081;53293545;38867444;277946;80.9;79.4;57.9;0.4
FR;2022-03-01;3196;7312;44773;5511;54273277;53300857;38912217;283457;80.9;79.4;58.0;0.4
FR;2022-03-02;5099;12553;49000;4920;54278376;53313410;38961217;288377;80.9;79.4;58.1;0.4
FR;2022-03-03;2684;5882;29930;4046;54281060;53319292;38991147;292423;80.9;79.4;58.1;0.4
FR;2022-03-04;3188;8223;39392;6211;54284248;53327515;39030539;298634;80.9;79.5;58.2;0.4
FR;2022-03-05;3022;7069;25086;3131;54287270;53334584;39055625;301765;80.9;79.5;58.2;0.4
FR;2022-03-06;510;1012;3431;378;54287780;53335596;39059056;302143;80.9;79.5;58.2;0.5
FR;2022-03-07;2050;3715;17663;3299;54289830;53339311;39076719;305442;80.9;79.5;58.2;0.5
FR;2022-03-08;1981;4176;17872;4089;54291811;53343487;39094591;309531;80.9;79.5;58.3;0.5
FR;2022-03-09;3464;8549;21232;4031;54295275;53352036;39115823;313562;80.9;79.5;58.3;0.5
FR;2022-03-10;1719;3849;15712;3395;54296994;53355885;39131535;316957;80.9;79.5;58.3;0.5
FR;2022-03-11;2346;5195;22235;5472;54299340;53361080;39153770;322429;80.9;79.5;58.3;0.5
FR;2022-03-12;2655;5437;16501;3132;54301995;53366517;39170271;325561;80.9;79.5;58.4;0.5
FR;2022-03-13;386;589;2260;530;54302381;53367106;39172531;326091;80.9;79.5;58.4;0.5
FR;2022-03-14;1472;2696;13793;7280;54303853;53369802;39186324;333371;80.9;79.5;58.4;0.5
FR;2022-03-15;1601;3032;14350;11016;54305454;53372834;39200674;344387;80.9;79.5;58.4;0.5
FR;2022-03-16;2947;5896;18044;16286;54308401;53378730;39218718;360673;80.9;79.5;58.4;0.5
FR;2022-03-17;1376;2545;11937;13294;54309777;53381275;39230655;373967;80.9;79.5;58.5;0.6
FR;2022-03-18;2208;3887;18039;22016;54311985;53385162;39248694;395983;80.9;79.5;58.5;0.6
FR;2022-03-19;2278;4023;12404;11403;54314263;53389185;39261098;407386;80.9;79.5;58.5;0.6
FR;2022-03-20;293;505;1922;1333;54314556;53389690;39263020;408719;80.9;79.5;58.5;0.6
FR;2022-03-21;1344;2074;11915;16900;54315900;53391764;39274935;425619;80.9;79.6;58.5;0.6
FR;2022-03-22;1464;2444;12516;22811;54317364;53394208;39287451;448430;80.9;79.6;58.5;0.7
FR;2022-03-23;2643;5049;17175;25246;54320007;53399257;39304626;473676;80.9;79.6;58.6;0.7
FR;2022-03-24;1356;2027;10624;19353;54321363;53401284;39315250;493029;80.9;79.6;58.6;0.7
FR;2022-03-25;2048;3382;16837;30777;54323411;53404666;39332087;523806;80.9;79.6;58.6;0.8
FR;2022-03-26;2218;3786;11500;14378;54325629;53408452;39343587;538184;80.9;79.6;58.6;0.8
FR;2022-03-27;354;501;1925;1735;54325983;53408953;39345512;539919;80.9;79.6;58.6;0.8
FR;2022-03-28;1414;2032;10585;19026;54327397;53410985;39356097;558945;80.9;79.6;58.6;0.8
FR;2022-03-29;1422;2041;12022;29231;54328819;53413026;39368119;588176;80.9;79.6;58.7;0.9
FR;2022-03-30;2814;4556;15029;29252;54331633;53417582;39383148;617428;81.0;79.6;58.7;0.9
FR;2022-03-31;1595;2157;12245;26501;54333228;53419739;39395393;643929;81.0;79.6;58.7;1.0
FR;2022-04-01;2109;2695;18602;33420;54335337;53422434;39413995;677349;81.0;79.6;58.7;1.0
FR;2022-04-02;1497;1974;8694;11270;54336834;53424408;39422689;688619;81.0;79.6;58.7;1.0
FR;2022-04-03;275;341;1573;1378;54337109;53424749;39424262;689997;81.0;79.6;58.7;1.0
FR;2022-04-04;1378;1600;11479;20545;54338487;53426349;39435741;710542;81.0;79.6;58.8;1.1
FR;2022-04-05;1598;1819;13112;35599;54340085;53428168;39448853;746141;81.0;79.6;58.8;1.1
FR;2022-04-06;2042;2717;12693;27799;54342127;53430885;39461546;773940;81.0;79.6;58.8;1.2
FR;2022-04-07;1431;1730;12800;35028;54343558;53432615;39474346;808968;81.0;79.6;58.8;1.2
FR;2022-04-08;2019;2411;17754;46033;54345577;53435026;39492100;855001;81.0;79.6;58.8;1.3
FR;2022-04-09;1346;1874;8840;14777;54346923;53436900;39500940;869778;81.0;79.6;58.9;1.3
FR;2022-04-10;278;370;1978;2254;54347201;53437270;39502918;872032;81.0;79.6;58.9;1.3
FR;2022-04-11;1192;1478;11422;24917;54348393;53438748;39514340;896949;81.0;79.6;58.9;1.3
FR;2022-04-12;1572;1666;13305;41494;54349965;53440414;39527645;938443;81.0;79.6;58.9;1.4
FR;2022-04-13;1856;2430;12918;33794;54351821;53442844;39540563;972237;81.0;79.6;58.9;1.4
FR;2022-04-14;1438;1607;12931;36640;54353259;53444451;39553494;1008877;81.0;79.6;58.9;1.5
FR;2022-04-15;1789;2077;14765;36939;54355048;53446528;39568259;1045816;81.0;79.6;59.0;1.6
FR;2022-04-16;1032;1232;6220;9409;54356080;53447760;39574479;1055225;81.0;79.6;59.0;1.6
FR;2022-04-17;185;202;1030;1232;54356265;53447962;39575509;1056457;81.0;79.6;59.0;1.6
FR;2022-04-18;154;248;2760;1263;54356419;53448210;39578269;1057720;81.0;79.6;59.0;1.6
FR;2022-04-19;1468;1757;12359;30491;54357887;53449967;39590628;1088211;81.0;79.6;59.0;1.6
FR;2022-04-20;1908;2440;12861;29825;54359795;53452407;39603489;1118036;81.0;79.6;59.0;1.7
FR;2022-04-21;1475;1697;12458;35422;54361270;53454104;39615947;1153458;81.0;79.6;59.0;1.7
FR;2022-04-22;1823;2230;15775;38966;54363093;53456334;39631722;1192424;81.0;79.6;59.1;1.8
FR;2022-04-23;1126;1441;7214;11427;54364219;53457775;39638936;1203851;81.0;79.7;59.1;1.8
FR;2022-04-24;244;305;1404;1835;54364463;53458080;39640340;1205686;81.0;79.7;59.1;1.8
FR;2022-04-25;1256;1526;10437;21911;54365719;53459606;39650777;1227597;81.0;79.7;59.1;1.8
FR;2022-04-26;1567;1894;13049;39113;54367286;53461500;39663826;1266710;81.0;79.7;59.1;1.9
FR;2022-04-27;1909;2210;11501;31009;54369195;53463710;39675327;1297719;81.0;79.7;59.1;1.9
FR;2022-04-28;1521;1714;12163;36089;54370716;53465424;39687490;1333808;81.0;79.7;59.1;2.0
FR;2022-04-29;1954;2243;14793;38371;54372670;53467667;39702283;1372179;81.0;79.7;59.2;2.0
FR;2022-04-30;1184;1278;6679;10559;54373854;53468945;39708962;1382738;81.0;79.7;59.2;2.1
FR;2022-05-01;186;208;886;1095;54374040;53469153;39709848;1383833;81.0;79.7;59.2;2.1
FR;2022-05-02;1170;1305;10780;18737;54375210;53470458;39720628;1402570;81.0;79.7;59.2;2.1
FR;2022-05-03;1735;1754;13302;35160;54376945;53472212;39733930;1437730;81.0;79.7;59.2;2.1
FR;2022-05-04;1811;1957;11959;25883;54378756;53474169;39745889;1463613;81.0;79.7;59.2;2.2
FR;2022-05-05;1618;1650;12235;33723;54380374;53475819;39758124;1497336;81.0;79.7;59.2;2.2
FR;2022-05-06;2048;2178;14633;37921;54382422;53477997;39772757;1535257;81.0;79.7;59.3;2.3
FR;2022-05-07;1181;1238;6387;10306;54383603;53479235;39779144;1545563;81.0;79.7;59.3;2.3
FR;2022-05-08;255;276;1219;1636;54383858;53479511;39780363;1547199;81.0;79.7;59.3;2.3
FR;2022-05-09;1249;1235;9680;20884;54385107;53480746;39790043;1568083;81.0;79.7;59.3;2.3
FR;2022-05-10;1622;1725;12839;39581;54386729;53482471;39802882;1607664;81.0;79.7;59.3;2.4
FR;2022-05-11;1918;2008;10508;28180;54388647;53484479;39813390;1635844;81.0;79.7;59.3;2.4
FR;2022-05-12;1511;1559;10748;36010;54390158;53486038;39824138;1671854;81.0;79.7;59.3;2.5
FR;2022-05-13;1917;1936;13170;38771;54392075;53487974;39837308;1710625;81.0;79.7;59.4;2.5
FR;2022-05-14;1119;1142;5705;11285;54393194;53489116;39843013;1721910;81.0;79.7;59.4;2.6
FR;2022-05-15;265;245;1315;1572;54393459;53489361;39844328;1723482;81.0;79.7;59.4;2.6
FR;2022-05-16;1139;1125;8450;21286;54394598;53490486;39852778;1744768;81.0;79.7;59.4;2.6
FR;2022-05-17;1524;1532;11229;38177;54396122;53492018;39864007;1782945;81.0;79.7;59.4;2.7
FR;2022-05-18;1730;1805;9349;27422;54397852;53493823;39873356;1810367;81.1;79.7;59.4;2.7
FR;2022-05-19;1375;1484;10400;35287;54399227;53495307;39883756;1845654;81.1;79.7;59.4;2.7
FR;2022-05-20;1824;1939;12573;39937;54401051;53497246;39896329;1885591;81.1;79.7;59.4;2.8
FR;2022-05-21;1130;1263;5463;10391;54402181;53498509;39901792;1895982;81.1;79.7;59.5;2.8
FR;2022-05-22;227;244;984;1530;54402408;53498753;39902776;1897512;81.1;79.7;59.5;2.8
FR;2022-05-23;1100;1254;8607;20577;54403508;53500007;39911383;1918089;81.1;79.7;59.5;2.9
FR;2022-05-24;1478;1615;10655;38638;54404986;53501622;39922038;1956727;81.1;79.7;59.5;2.9
FR;2022-05-25;1752;1941;9195;24895;54406738;53503563;39931233;1981622;81.1;79.7;59.5;3.0
FR;2022-05-26;166;170;1215;1205;54406904;53503733;39932448;1982827;81.1;79.7;59.5;3.0
FR;2022-05-27;1311;1479;8098;22045;54408215;53505212;39940546;2004872;81.1;79.7;59.5;3.0
FR;2022-05-28;641;784;3725;7133;54408856;53505996;39944271;2012005;81.1;79.7;59.5;3.0
FR;2022-05-29;139;187;745;1010;54408995;53506183;39945016;2013015;81.1;79.7;59.5;3.0
FR;2022-05-30;969;1156;6507;19436;54409964;53507339;39951523;2032451;81.1;79.7;59.5;3.0
FR;2022-05-31;1438;1472;9420;35816;54411402;53508811;39960943;2068267;81.1;79.7;59.5;3.1
FR;2022-06-01;1502;1752;8029;24642;54412904;53510563;39968972;2092909;81.1;79.7;59.6;3.1
FR;2022-06-02;1336;1499;8685;35633;54414240;53512062;39977657;2128542;81.1;79.7;59.6;3.2
FR;2022-06-03;1576;1833;10193;39184;54415816;53513895;39987850;2167726;81.1;79.7;59.6;3.2
FR;2022-06-04;907;1021;4336;9439;54416723;53514916;39992186;2177165;81.1;79.7;59.6;3.2
FR;2022-06-05;148;180;801;1140;54416871;53515096;39992987;2178305;81.1;79.7;59.6;3.2
FR;2022-06-06;145;173;790;1215;54417016;53515269;39993777;2179520;81.1;79.7;59.6;3.2
FR;2022-06-07;1269;1541;8453;36039;54418285;53516810;40002230;2215559;81.1;79.7;59.6;3.3
FR;2022-06-08;1454;1752;7628;28967;54419739;53518562;40009858;2244526;81.1;79.7;59.6;3.3
FR;2022-06-09;1202;1336;8160;38950;54420941;53519898;40018018;2283476;81.1;79.7;59.6;3.4
FR;2022-06-10;1477;1605;9986;44559;54422418;53521503;40028004;2328035;81.1;79.7;59.6;3.5
FR;2022-06-11;865;988;4667;11793;54423283;53522491;40032671;2339828;81.1;79.7;59.6;3.5
FR;2022-06-12;136;169;936;1670;54423419;53522660;40033607;2341498;81.1;79.7;59.6;3.5
