fra;jour;n_dose1;n_complet;n_rappel;n_2_rappel;n_cum_dose1;n_cum_complet;n_cum_rappel;n_cum_2_rappel;couv_dose1;couv_complet;couv_rappel;couv_2_rappel
FR;2020-12-27;601;54;0;0;601;54;0;0;0.0;0.0;0.0;0.0
FR;2020-12-28;663;42;0;0;1264;96;0;0;0.0;0.0;0.0;0.0
FR;2020-12-29;371;19;0;0;1635;115;0;0;0.0;0.0;0.0;0.0
FR;2020-12-30;437;18;0;0;2072;133;0;0;0.0;0.0;0.0;0.0
FR;2020-12-31;413;22;0;0;2485;155;0;0;0.0;0.0;0.0;0.0
FR;2021-01-01;1135;64;0;0;3620;219;0;0;0.0;0.0;0.0;0.0
FR;2021-01-02;356;30;0;0;3976;249;0;0;0.0;0.0;0.0;0.0
FR;2021-01-03;398;27;0;0;4374;276;0;0;0.0;0.0;0.0;0.0
FR;2021-01-04;2086;48;0;0;6460;324;0;0;0.0;0.0;0.0;0.0
FR;2021-01-05;7547;119;0;0;14007;443;0;0;0.0;0.0;0.0;0.0
FR;2021-01-06;12410;119;0;0;26417;562;0;0;0.0;0.0;0.0;0.0
FR;2021-01-07;29445;158;0;0;55862;720;0;0;0.1;0.0;0.0;0.0
FR;2021-01-08;37121;195;0;0;92983;915;0;0;0.1;0.0;0.0;0.0
FR;2021-01-09;11209;76;0;0;104192;991;0;0;0.2;0.0;0.0;0.0
FR;2021-01-10;5996;24;0;0;110188;1015;0;0;0.2;0.0;0.0;0.0
FR;2021-01-11;39922;226;0;0;150110;1241;0;0;0.2;0.0;0.0;0.0
FR;2021-01-12;62119;311;0;0;212229;1552;0;0;0.3;0.0;0.0;0.0
FR;2021-01-13;65096;436;0;0;277325;1988;0;0;0.4;0.0;0.0;0.0
FR;2021-01-14;83124;1190;0;0;360449;3178;0;0;0.5;0.0;0.0;0.0
FR;2021-01-15;68985;559;0;0;429434;3737;0;0;0.6;0.0;0.0;0.0
FR;2021-01-16;20208;189;0;0;449642;3926;0;0;0.7;0.0;0.0;0.0
FR;2021-01-17;10976;131;0;0;460618;4057;0;0;0.7;0.0;0.0;0.0
FR;2021-01-18;85873;614;0;0;546491;4671;0;0;0.8;0.0;0.0;0.0
FR;2021-01-19;130569;865;0;0;677060;5536;0;0;1.0;0.0;0.0;0.0
FR;2021-01-20;137522;851;0;0;814582;6387;0;0;1.2;0.0;0.0;0.0
FR;2021-01-21;158368;973;0;0;972950;7360;0;0;1.4;0.0;0.0;0.0
FR;2021-01-22;121036;831;0;0;1093986;8191;0;0;1.6;0.0;0.0;0.0
FR;2021-01-23;38464;203;0;0;1132450;8394;0;0;1.7;0.0;0.0;0.0
FR;2021-01-24;9740;134;0;0;1142190;8528;0;0;1.7;0.0;0.0;0.0
FR;2021-01-25;78216;1630;0;0;1220406;10158;0;0;1.8;0.0;0.0;0.0
FR;2021-01-26;100358;3754;0;0;1320764;13912;0;0;2.0;0.0;0.0;0.0
FR;2021-01-27;107222;6634;0;0;1427986;20546;0;0;2.1;0.0;0.0;0.0
FR;2021-01-28;124322;15747;0;0;1552308;36293;0;0;2.3;0.1;0.0;0.0
FR;2021-01-29;92169;18245;0;0;1644477;54538;0;0;2.5;0.1;0.0;0.0
FR;2021-01-30;29110;4373;0;0;1673587;58911;0;0;2.5;0.1;0.0;0.0
FR;2021-01-31;5225;1765;0;0;1678812;60676;0;0;2.5;0.1;0.0;0.0
FR;2021-02-01;53103;21741;0;0;1731915;82417;0;0;2.6;0.1;0.0;0.0
FR;2021-02-02;72273;36079;0;0;1804188;118496;0;0;2.7;0.2;0.0;0.0
FR;2021-02-03;72284;38302;0;0;1876472;156798;0;0;2.8;0.2;0.0;0.0
FR;2021-02-04;82046;51904;0;0;1958518;208702;0;0;2.9;0.3;0.0;0.0
FR;2021-02-05;68216;46387;0;0;2026734;255089;0;0;3.0;0.4;0.0;0.0
FR;2021-02-06;23114;10966;0;0;2049848;266055;0;0;3.1;0.4;0.0;0.0
FR;2021-02-07;5181;5358;0;0;2055029;271413;0;0;3.1;0.4;0.0;0.0
FR;2021-02-08;46815;47207;0;0;2101844;318620;0;0;3.1;0.5;0.0;0.0
FR;2021-02-09;65990;75175;0;0;2167834;393795;0;0;3.2;0.6;0.0;0.0
FR;2021-02-10;70980;80179;0;0;2238814;473974;0;0;3.3;0.7;0.0;0.0
FR;2021-02-11;87234;102699;0;0;2326048;576673;0;0;3.5;0.9;0.0;0.0
FR;2021-02-12;79286;76444;0;0;2405334;653117;0;0;3.6;1.0;0.0;0.0
FR;2021-02-13;22351;19817;0;0;2427685;672934;0;0;3.6;1.0;0.0;0.0
FR;2021-02-14;5070;7277;0;0;2432755;680211;0;0;3.6;1.0;0.0;0.0
FR;2021-02-15;38068;77389;0;0;2470823;757600;0;0;3.7;1.1;0.0;0.0
FR;2021-02-16;50361;101632;0;0;2521184;859232;0;0;3.8;1.3;0.0;0.0
FR;2021-02-17;50494;105772;0;0;2571678;965004;0;0;3.8;1.4;0.0;0.0
FR;2021-02-18;69755;121965;0;0;2641433;1086969;0;0;3.9;1.6;0.0;0.0
FR;2021-02-19;65047;92651;0;0;2706480;1179620;0;0;4.0;1.8;0.0;0.0
FR;2021-02-20;18573;28847;0;0;2725053;1208467;0;0;4.1;1.8;0.0;0.0
FR;2021-02-21;3314;6410;0;0;2728367;1214877;0;0;4.1;1.8;0.0;0.0
FR;2021-02-22;37476;73924;0;0;2765843;1288801;0;0;4.1;1.9;0.0;0.0
FR;2021-02-23;53758;85778;0;0;2819601;1374579;0;0;4.2;2.0;0.0;0.0
FR;2021-02-24;59977;83030;0;0;2879578;1457609;0;0;4.3;2.2;0.0;0.0
FR;2021-02-25;100541;94205;0;0;2980119;1551814;0;0;4.4;2.3;0.0;0.0
FR;2021-02-26;113422;73741;0;0;3093541;1625555;0;0;4.6;2.4;0.0;0.0
FR;2021-02-27;52091;23338;0;0;3145632;1648893;0;0;4.7;2.5;0.0;0.0
FR;2021-02-28;6190;4490;0;0;3151822;1653383;0;0;4.7;2.5;0.0;0.0
FR;2021-03-01;65826;55056;0;0;3217648;1708439;0;0;4.8;2.5;0.0;0.0
FR;2021-03-02;101345;69493;0;0;3318993;1777932;0;0;4.9;2.6;0.0;0.0
FR;2021-03-03;116459;69096;0;0;3435452;1847028;0;0;5.1;2.8;0.0;0.0
FR;2021-03-04;163579;75585;0;0;3599031;1922613;0;0;5.4;2.9;0.0;0.0
FR;2021-03-05;200880;69786;0;0;3799911;1992399;0;0;5.7;3.0;0.0;0.0
FR;2021-03-06;207920;23031;0;0;4007831;2015430;0;0;6.0;3.0;0.0;0.0
FR;2021-03-07;121250;8309;0;0;4129081;2023739;0;0;6.2;3.0;0.0;0.0
FR;2021-03-08;107110;53804;0;0;4236191;2077543;0;0;6.3;3.1;0.0;0.0
FR;2021-03-09;172409;61903;0;0;4408600;2139446;0;0;6.6;3.2;0.0;0.0
FR;2021-03-10;178931;62711;0;0;4587531;2202157;0;0;6.8;3.3;0.0;0.0
FR;2021-03-11;242820;71422;0;0;4830351;2273579;0;0;7.2;3.4;0.0;0.0
FR;2021-03-12;294769;62821;0;0;5125120;2336400;0;0;7.6;3.5;0.0;0.0
FR;2021-03-13;231369;21292;0;0;5356489;2357692;0;0;8.0;3.5;0.0;0.0
FR;2021-03-14;63334;5369;0;0;5419823;2363061;0;0;8.1;3.5;0.0;0.0
FR;2021-03-15;158598;36813;0;0;5578421;2399874;0;0;8.3;3.6;0.0;0.0
FR;2021-03-16;141537;43238;0;0;5719958;2443112;0;0;8.5;3.6;0.0;0.0
FR;2021-03-17;150440;42947;0;0;5870398;2486059;0;0;8.7;3.7;0.0;0.0
FR;2021-03-18;167776;50039;0;0;6038174;2536098;0;0;9.0;3.8;0.0;0.0
FR;2021-03-19;229959;44517;0;0;6268133;2580615;0;0;9.3;3.8;0.0;0.0
FR;2021-03-20;166639;16224;0;0;6434772;2596839;0;0;9.6;3.9;0.0;0.0
FR;2021-03-21;49917;4283;0;0;6484689;2601122;0;0;9.7;3.9;0.0;0.0
FR;2021-03-22;169992;39462;0;0;6654681;2640584;0;0;9.9;3.9;0.0;0.0
FR;2021-03-23;250329;50171;0;0;6905010;2690755;0;0;10.3;4.0;0.0;0.0
FR;2021-03-24;256846;51738;0;0;7161856;2742493;0;0;10.7;4.1;0.0;0.0
FR;2021-03-25;341744;55789;0;0;7503600;2798282;0;0;11.2;4.2;0.0;0.0
FR;2021-03-26;358741;53533;0;0;7862341;2851815;0;0;11.7;4.2;0.0;0.0
FR;2021-03-27;195237;23140;0;0;8057578;2874955;0;0;12.0;4.3;0.0;0.0
FR;2021-03-28;59321;6048;0;0;8116899;2881003;0;0;12.1;4.3;0.0;0.0
FR;2021-03-29;202926;60700;0;0;8319825;2941703;0;0;12.4;4.4;0.0;0.0
FR;2021-03-30;285405;79979;0;0;8605230;3021682;0;0;12.8;4.5;0.0;0.0
FR;2021-03-31;262960;83793;0;0;8868190;3105475;0;0;13.2;4.6;0.0;0.0
FR;2021-04-01;315380;102600;0;0;9183570;3208075;0;0;13.7;4.8;0.0;0.0
FR;2021-04-02;281272;104455;0;0;9464842;3312530;0;0;14.1;4.9;0.0;0.0
FR;2021-04-03;141046;67110;0;0;9605888;3379640;0;0;14.3;5.0;0.0;0.0
FR;2021-04-04;46448;20765;0;0;9652336;3400405;0;0;14.4;5.1;0.0;0.0
FR;2021-04-05;63304;13464;0;0;9715640;3413869;0;0;14.5;5.1;0.0;0.0
FR;2021-04-06;217139;117819;0;0;9932779;3531688;0;0;14.8;5.3;0.0;0.0
FR;2021-04-07;260184;126596;0;0;10192963;3658284;0;0;15.2;5.5;0.0;0.0
FR;2021-04-08;337731;137148;0;0;10530694;3795432;0;0;15.7;5.7;0.0;0.0
FR;2021-04-09;410076;133574;0;0;10940770;3929006;0;0;16.3;5.9;0.0;0.0
FR;2021-04-10;212578;90939;0;0;11153348;4019945;0;0;16.6;6.0;0.0;0.0
FR;2021-04-11;56121;36946;0;0;11209469;4056891;0;0;16.7;6.0;0.0;0.0
FR;2021-04-12;236994;124705;0;0;11446463;4181596;0;0;17.1;6.2;0.0;0.0
FR;2021-04-13;309415;157375;0;0;11755878;4338971;0;0;17.5;6.5;0.0;0.0
FR;2021-04-14;294430;152546;0;0;12050308;4491517;0;0;18.0;6.7;0.0;0.0
FR;2021-04-15;337002;163710;0;0;12387310;4655227;0;0;18.5;6.9;0.0;0.0
FR;2021-04-16;339221;160433;0;0;12726531;4815660;0;0;19.0;7.2;0.0;0.0
FR;2021-04-17;188619;97676;0;0;12915150;4913336;0;0;19.2;7.3;0.0;0.0
FR;2021-04-18;51600;37782;0;0;12966750;4951118;0;0;19.3;7.4;0.0;0.0
FR;2021-04-19;205637;147244;0;0;13172387;5098362;0;0;19.6;7.6;0.0;0.0
FR;2021-04-20;254339;182316;0;0;13426726;5280678;0;0;20.0;7.9;0.0;0.0
FR;2021-04-21;253174;180979;0;0;13679900;5461657;0;0;20.4;8.1;0.0;0.0
FR;2021-04-22;287482;203123;0;0;13967382;5664780;0;0;20.8;8.4;0.0;0.0
FR;2021-04-23;297925;202408;0;0;14265307;5867188;0;0;21.3;8.7;0.0;0.0
FR;2021-04-24;190407;121940;0;0;14455714;5989128;0;0;21.5;8.9;0.0;0.0
FR;2021-04-25;69536;42502;0;0;14525250;6031630;0;0;21.6;9.0;0.0;0.0
FR;2021-04-26;220888;169363;0;0;14746138;6200993;0;0;22.0;9.2;0.0;0.0
FR;2021-04-27;284543;210559;0;0;15030681;6411552;0;0;22.4;9.6;0.0;0.0
FR;2021-04-28;299430;208187;1;0;15330111;6619739;1;0;22.8;9.9;0.0;0.0
FR;2021-04-29;357050;231446;0;0;15687161;6851185;1;0;23.4;10.2;0.0;0.0
FR;2021-04-30;372128;224047;0;0;16059289;7075232;1;0;23.9;10.5;0.0;0.0
FR;2021-05-01;167594;63730;0;0;16226883;7138962;1;0;24.2;10.6;0.0;0.0
FR;2021-05-02;91697;43464;0;0;16318580;7182426;1;0;24.3;10.7;0.0;0.0
FR;2021-05-03;288848;188961;0;0;16607428;7371387;1;0;24.7;11.0;0.0;0.0
FR;2021-05-04;315582;250464;0;0;16923010;7621851;1;0;25.2;11.4;0.0;0.0
FR;2021-05-05;327088;249653;0;0;17250098;7871504;1;0;25.7;11.7;0.0;0.0
FR;2021-05-06;379415;273552;0;0;17629513;8145056;1;0;26.3;12.1;0.0;0.0
FR;2021-05-07;372673;298190;0;0;18002186;8443246;1;0;26.8;12.6;0.0;0.0
FR;2021-05-08;222132;82467;0;0;18224318;8525713;1;0;27.2;12.7;0.0;0.0
FR;2021-05-09;129682;55050;0;0;18354000;8580763;1;0;27.3;12.8;0.0;0.0
FR;2021-05-10;313292;254392;0;0;18667292;8835155;1;0;27.8;13.2;0.0;0.0
FR;2021-05-11;403805;296147;0;0;19071097;9131302;1;0;28.4;13.6;0.0;0.0
FR;2021-05-12;434023;269223;0;0;19505120;9400525;1;0;29.1;14.0;0.0;0.0
FR;2021-05-13;338542;78407;0;0;19843662;9478932;1;0;29.6;14.1;0.0;0.0
FR;2021-05-14;454049;202744;0;0;20297711;9681676;1;0;30.2;14.4;0.0;0.0
FR;2021-05-15;374914;120365;0;0;20672625;9802041;1;0;30.8;14.6;0.0;0.0
FR;2021-05-16;202716;34184;0;0;20875341;9836225;1;0;31.1;14.7;0.0;0.0
FR;2021-05-17;376053;178557;0;0;21251394;10014782;1;0;31.7;14.9;0.0;0.0
FR;2021-05-18;460051;192174;0;0;21711445;10206956;1;0;32.3;15.2;0.0;0.0
FR;2021-05-19;467287;182033;0;0;22178732;10388989;1;0;33.0;15.5;0.0;0.0
FR;2021-05-20;507392;204147;0;0;22686124;10593136;1;0;33.8;15.8;0.0;0.0
FR;2021-05-21;489551;220807;0;0;23175675;10813943;1;0;34.5;16.1;0.0;0.0
FR;2021-05-22;347137;108266;0;0;23522812;10922209;1;0;35.0;16.3;0.0;0.0
FR;2021-05-23;161635;26883;0;0;23684447;10949092;1;0;35.3;16.3;0.0;0.0
FR;2021-05-24;263128;53013;0;0;23947575;11002105;1;0;35.7;16.4;0.0;0.0
FR;2021-05-25;400133;225646;0;0;24347708;11227751;1;0;36.3;16.7;0.0;0.0
FR;2021-05-26;413354;226402;0;0;24761062;11454153;1;0;36.9;17.1;0.0;0.0
FR;2021-05-27;449697;265608;0;0;25210759;11719761;1;0;37.6;17.5;0.0;0.0
FR;2021-05-28;429440;317393;0;0;25640199;12037154;1;0;38.2;17.9;0.0;0.0
FR;2021-05-29;298937;182116;0;0;25939136;12219270;1;0;38.6;18.2;0.0;0.0
FR;2021-05-30;107094;42162;0;0;26046230;12261432;1;0;38.8;18.3;0.0;0.0
FR;2021-05-31;357910;241604;1;0;26404140;12503036;2;0;39.3;18.6;0.0;0.0
FR;2021-06-01;430823;302818;1;0;26834963;12805854;3;0;40.0;19.1;0.0;0.0
FR;2021-06-02;419281;278112;0;0;27254244;13083966;3;0;40.6;19.5;0.0;0.0
FR;2021-06-03;464517;313030;0;0;27718761;13396996;3;0;41.3;20.0;0.0;0.0
FR;2021-06-04;455679;361982;1;0;28174440;13758978;4;0;42.0;20.5;0.0;0.0
FR;2021-06-05;304742;222132;0;0;28479182;13981110;4;0;42.4;20.8;0.0;0.0
FR;2021-06-06;133236;61274;0;0;28612418;14042384;4;0;42.6;20.9;0.0;0.0
FR;2021-06-07;338925;298996;0;0;28951343;14341380;4;0;43.1;21.4;0.0;0.0
FR;2021-06-08;393553;337755;0;0;29344896;14679135;4;0;43.7;21.9;0.0;0.0
FR;2021-06-09;384654;319851;0;0;29729550;14998986;4;0;44.3;22.3;0.0;0.0
FR;2021-06-10;403955;338309;0;0;30133505;15337295;4;0;44.9;22.9;0.0;0.0
FR;2021-06-11;386460;407553;0;0;30519965;15744848;4;0;45.5;23.5;0.0;0.0
FR;2021-06-12;283202;243389;0;0;30803167;15988237;4;0;45.9;23.8;0.0;0.0
FR;2021-06-13;104828;84984;0;0;30907995;16073221;4;0;46.1;23.9;0.0;0.0
FR;2021-06-14;240644;384658;0;0;31148639;16457879;4;0;46.4;24.5;0.0;0.0
FR;2021-06-15;307971;424347;0;0;31456610;16882226;4;0;46.9;25.2;0.0;0.0
FR;2021-06-16;313832;395483;0;0;31770442;17277709;4;0;47.3;25.7;0.0;0.0
FR;2021-06-17;317551;413573;0;0;32087993;17691282;4;0;47.8;26.4;0.0;0.0
FR;2021-06-18;321550;485748;0;0;32409543;18177030;4;0;48.3;27.1;0.0;0.0
FR;2021-06-19;224303;300940;0;0;32633846;18477970;4;0;48.6;27.5;0.0;0.0
FR;2021-06-20;74366;111784;0;0;32708212;18589754;4;0;48.7;27.7;0.0;0.0
FR;2021-06-21;195561;427734;1;0;32903773;19017488;5;0;49.0;28.3;0.0;0.0
FR;2021-06-22;222997;499979;2;0;33126770;19517467;7;0;49.4;29.1;0.0;0.0
FR;2021-06-23;233861;474042;1;0;33360631;19991509;8;0;49.7;29.8;0.0;0.0
FR;2021-06-24;241722;447082;0;0;33602353;20438591;8;0;50.1;30.5;0.0;0.0
FR;2021-06-25;227460;561188;0;0;33829813;20999779;8;0;50.4;31.3;0.0;0.0
FR;2021-06-26;153190;395469;0;0;33983003;21395248;8;0;50.6;31.9;0.0;0.0
FR;2021-06-27;55861;165130;0;0;34038864;21560378;8;0;50.7;32.1;0.0;0.0
FR;2021-06-28;154610;478405;0;0;34193474;22038783;8;0;50.9;32.8;0.0;0.0
FR;2021-06-29;182536;538263;0;0;34376010;22577046;8;0;51.2;33.6;0.0;0.0
FR;2021-06-30;203832;516712;2;0;34579842;23093758;10;0;51.5;34.4;0.0;0.0
FR;2021-07-01;231091;497936;1;0;34810933;23591694;11;0;51.9;35.2;0.0;0.0
FR;2021-07-02;228287;562676;3;0;35039220;24154370;14;0;52.2;36.0;0.0;0.0
FR;2021-07-03;141927;395312;1;0;35181147;24549682;15;0;52.4;36.6;0.0;0.0
FR;2021-07-04;56688;150979;0;0;35237835;24700661;15;0;52.5;36.8;0.0;0.0
FR;2021-07-05;168198;449388;2;0;35406033;25150049;17;0;52.8;37.5;0.0;0.0
FR;2021-07-06;196541;511533;8;0;35602574;25661582;25;0;53.0;38.2;0.0;0.0
FR;2021-07-07;212913;477918;5;0;35815487;26139500;30;0;53.4;38.9;0.0;0.0
FR;2021-07-08;231432;468287;7;0;36046919;26607787;37;0;53.7;39.6;0.0;0.0
FR;2021-07-09;228338;557142;2;0;36275257;27164929;39;0;54.0;40.5;0.0;0.0
FR;2021-07-10;148529;368889;1;0;36423786;27533818;40;0;54.3;41.0;0.0;0.0
FR;2021-07-11;60138;121095;0;0;36483924;27654913;40;0;54.4;41.2;0.0;0.0
FR;2021-07-12;168950;513169;0;0;36652874;28168082;40;0;54.6;42.0;0.0;0.0
FR;2021-07-13;287044;586696;2;0;36939918;28754778;42;0;55.0;42.8;0.0;0.0
FR;2021-07-14;180874;187155;0;0;37120792;28941933;42;0;55.3;43.1;0.0;0.0
FR;2021-07-15;346851;572752;0;0;37467643;29514685;42;0;55.8;44.0;0.0;0.0
FR;2021-07-16;379895;575419;1;0;37847538;30090104;43;0;56.4;44.8;0.0;0.0
FR;2021-07-17;259648;368948;0;0;38107186;30459052;43;0;56.8;45.4;0.0;0.0
FR;2021-07-18;109663;133312;0;0;38216849;30592364;43;0;56.9;45.6;0.0;0.0
FR;2021-07-19;285306;480301;0;0;38502155;31072665;43;0;57.4;46.3;0.0;0.0
FR;2021-07-20;376711;524981;0;0;38878866;31597646;43;0;57.9;47.1;0.0;0.0
FR;2021-07-21;395618;483159;2;0;39274484;32080805;45;0;58.5;47.8;0.0;0.0
FR;2021-07-22;440869;472852;2;0;39715353;32553657;47;0;59.2;48.5;0.0;0.0
FR;2021-07-23;439789;511397;2;0;40155142;33065054;49;0;59.8;49.3;0.0;0.0
FR;2021-07-24;285177;322374;0;0;40440319;33387428;49;0;60.3;49.7;0.0;0.0
FR;2021-07-25;121050;100471;0;0;40561369;33487899;49;0;60.4;49.9;0.0;0.0
FR;2021-07-26;347237;385984;2;0;40908606;33873883;51;0;61.0;50.5;0.0;0.0
FR;2021-07-27;463877;401719;2;0;41372483;34275602;53;0;61.6;51.1;0.0;0.0
FR;2021-07-28;459286;367905;2;0;41831769;34643507;55;0;62.3;51.6;0.0;0.0
FR;2021-07-29;489676;358099;1;0;42321445;35001606;56;0;63.1;52.2;0.0;0.0
FR;2021-07-30;461623;381672;2;0;42783068;35383278;58;0;63.7;52.7;0.0;0.0
FR;2021-07-31;285338;231693;0;0;43068406;35614971;58;0;64.2;53.1;0.0;0.0
FR;2021-08-01;111933;65838;0;0;43180339;35680809;58;0;64.3;53.2;0.0;0.0
FR;2021-08-02;341202;285576;0;0;43521541;35966385;58;0;64.8;53.6;0.0;0.0
FR;2021-08-03;398387;305474;1;0;43919928;36271859;59;0;65.4;54.0;0.0;0.0
FR;2021-08-04;384608;266518;3;0;44304536;36538377;62;0;66.0;54.4;0.0;0.0
FR;2021-08-05;365971;282633;0;0;44670507;36821010;62;0;66.6;54.9;0.0;0.0
FR;2021-08-06;359540;327408;1;0;45030047;37148418;63;0;67.1;55.4;0.0;0.0
FR;2021-08-07;213032;210272;3;0;45243079;37358690;66;0;67.4;55.7;0.0;0.0
FR;2021-08-08;74128;73751;0;0;45317207;37432441;66;0;67.5;55.8;0.0;0.0
FR;2021-08-09;258570;298720;3;0;45575777;37731161;69;0;67.9;56.2;0.0;0.0
FR;2021-08-10;306586;324729;1;0;45882363;38055890;70;0;68.4;56.7;0.0;0.0
FR;2021-08-11;279512;302652;1;0;46161875;38358542;71;0;68.8;57.2;0.0;0.0
FR;2021-08-12;271363;321228;1;0;46433238;38679770;72;0;69.2;57.6;0.0;0.0
FR;2021-08-13;252028;317029;2;0;46685266;38996799;74;0;69.6;58.1;0.0;0.0
FR;2021-08-14;145271;219432;0;0;46830537;39216231;74;0;69.8;58.4;0.0;0.0
FR;2021-08-15;39296;55728;0;0;46869833;39271959;74;0;69.8;58.5;0.0;0.0
FR;2021-08-16;186033;346364;0;0;47055866;39618323;74;0;70.1;59.0;0.0;0.0
FR;2021-08-17;215551;369956;1;0;47271417;39988279;75;0;70.4;59.6;0.0;0.0
FR;2021-08-18;198915;355304;4;0;47470332;40343583;79;0;70.7;60.1;0.0;0.0
FR;2021-08-19;191873;356648;0;0;47662205;40700231;79;0;71.0;60.6;0.0;0.0
FR;2021-08-20;186334;397170;2;0;47848539;41097401;81;0;71.3;61.2;0.0;0.0
FR;2021-08-21;104746;254755;0;0;47953285;41352156;81;0;71.4;61.6;0.0;0.0
FR;2021-08-22;31885;92210;1;0;47985170;41444366;82;0;71.5;61.8;0.0;0.0
FR;2021-08-23;140881;380220;2;0;48126051;41824586;84;0;71.7;62.3;0.0;0.0
FR;2021-08-24;162397;403611;1;0;48288448;42228197;85;0;71.9;62.9;0.0;0.0
FR;2021-08-25;151057;376067;3;0;48439505;42604264;88;0;72.2;63.5;0.0;0.0
FR;2021-08-26;142729;368375;1;0;48582234;42972639;89;0;72.4;64.0;0.0;0.0
FR;2021-08-27;148360;415544;4;0;48730594;43388183;93;0;72.6;64.6;0.0;0.0
FR;2021-08-28;90595;265290;0;0;48821189;43653473;93;0;72.7;65.0;0.0;0.0
FR;2021-08-29;27304;88404;0;0;48848493;43741877;93;0;72.8;65.2;0.0;0.0
FR;2021-08-30;117320;342671;6028;1;48965813;44084548;6121;1;73.0;65.7;0.0;0.0
FR;2021-08-31;128712;354219;11882;2;49094525;44438767;18003;3;73.1;66.2;0.0;0.0
FR;2021-09-01;135713;302706;24306;3;49230238;44741473;42309;6;73.4;66.7;0.1;0.0
FR;2021-09-02;112573;262503;28851;1;49342811;45003976;71160;7;73.5;67.1;0.1;0.0
FR;2021-09-03;118163;309723;32959;6;49460974;45313699;104119;13;73.7;67.5;0.2;0.0
FR;2021-09-04;89793;230674;14069;5;49550767;45544373;118188;18;73.8;67.9;0.2;0.0
FR;2021-09-05;21333;48362;4729;0;49572100;45592735;122917;18;73.9;67.9;0.2;0.0
FR;2021-09-06;75311;191217;34241;2;49647411;45783952;157158;20;74.0;68.2;0.2;0.0
FR;2021-09-07;80039;191518;36091;3;49727450;45975470;193249;23;74.1;68.5;0.3;0.0
FR;2021-09-08;89625;216961;32453;6;49817075;46192431;225702;29;74.2;68.8;0.3;0.0
FR;2021-09-09;76627;174523;36516;16;49893702;46366954;262218;45;74.3;69.1;0.4;0.0
FR;2021-09-10;95554;215265;40496;13;49989256;46582219;302714;58;74.5;69.4;0.5;0.0
FR;2021-09-11;66702;178310;14305;1;50055958;46760529;317019;59;74.6;69.7;0.5;0.0
FR;2021-09-12;12788;34164;3159;2;50068746;46794693;320178;61;74.6;69.7;0.5;0.0
FR;2021-09-13;64365;134688;44042;29;50133111;46929381;364220;90;74.7;69.9;0.5;0.0
FR;2021-09-14;73295;136333;61992;51;50206406;47065714;426212;141;74.8;70.1;0.6;0.0
FR;2021-09-15;76399;174885;54771;100;50282805;47240599;480983;241;74.9;70.4;0.7;0.0
FR;2021-09-16;63748;117997;60009;128;50346553;47358596;540992;369;75.0;70.6;0.8;0.0
FR;2021-09-17;74953;159831;57221;94;50421506;47518427;598213;463;75.1;70.8;0.9;0.0
FR;2021-09-18;48185;144342;17283;24;50469691;47662769;615496;487;75.2;71.0;0.9;0.0
FR;2021-09-19;7863;24924;2621;3;50477554;47687693;618117;490;75.2;71.1;0.9;0.0
FR;2021-09-20;44436;96451;50250;56;50521990;47784144;668367;546;75.3;71.2;1.0;0.0
FR;2021-09-21;45803;98535;63355;128;50567793;47882679;731722;674;75.3;71.3;1.1;0.0
FR;2021-09-22;48580;144830;55340;68;50616373;48027509;787062;742;75.4;71.6;1.2;0.0
FR;2021-09-23;43150;91245;63460;127;50659523;48118754;850522;869;75.5;71.7;1.3;0.0
FR;2021-09-24;52189;132455;59083;105;50711712;48251209;909605;974;75.6;71.9;1.4;0.0
FR;2021-09-25;35191;118550;18251;27;50746903;48369759;927856;1001;75.6;72.1;1.4;0.0
FR;2021-09-26;5524;18688;2329;5;50752427;48388447;930185;1006;75.6;72.1;1.4;0.0
FR;2021-09-27;33917;78891;48119;114;50786344;48467338;978304;1120;75.7;72.2;1.5;0.0
FR;2021-09-28;36444;74408;56451;86;50822788;48541746;1034755;1206;75.7;72.3;1.5;0.0
FR;2021-09-29;44309;103038;54803;79;50867097;48644784;1089558;1285;75.8;72.5;1.6;0.0
FR;2021-09-30;36265;71377;59465;91;50903362;48716161;1149023;1376;75.8;72.6;1.7;0.0
FR;2021-10-01;61494;99684;63676;54;50964856;48815845;1212699;1430;75.9;72.7;1.8;0.0
FR;2021-10-02;39410;81677;23317;18;51004266;48897522;1236016;1448;76.0;72.9;1.8;0.0
FR;2021-10-03;5261;11296;2539;4;51009527;48908818;1238555;1452;76.0;72.9;1.8;0.0
FR;2021-10-04;34926;59564;54769;82;51044453;48968382;1293324;1534;76.1;73.0;1.9;0.0
FR;2021-10-05;33537;62212;64908;75;51077990;49030594;1358232;1609;76.1;73.1;2.0;0.0
FR;2021-10-06;42399;80224;68205;43;51120389;49110818;1426437;1652;76.2;73.2;2.1;0.0
FR;2021-10-07;30388;59459;68651;88;51150777;49170277;1495088;1740;76.2;73.3;2.2;0.0
FR;2021-10-08;48715;89888;84610;71;51199492;49260165;1579698;1811;76.3;73.4;2.4;0.0
FR;2021-10-09;33619;64131;33851;21;51233111;49324296;1613549;1832;76.3;73.5;2.4;0.0
FR;2021-10-10;4586;7926;3483;2;51237697;49332222;1617032;1834;76.3;73.5;2.4;0.0
FR;2021-10-11;30548;50657;64021;94;51268245;49382879;1681053;1928;76.4;73.6;2.5;0.0
FR;2021-10-12;31314;51441;75819;62;51299559;49434320;1756872;1990;76.4;73.7;2.6;0.0
FR;2021-10-13;39972;62841;79239;51;51339531;49497161;1836111;2041;76.5;73.7;2.7;0.0
FR;2021-10-14;30217;49739;73752;49;51369748;49546900;1909863;2090;76.5;73.8;2.8;0.0
FR;2021-10-15;44727;70444;102888;60;51414475;49617344;2012751;2150;76.6;73.9;3.0;0.0
FR;2021-10-16;31267;46724;39604;24;51445742;49664068;2052355;2174;76.7;74.0;3.1;0.0
FR;2021-10-17;3826;5694;3691;3;51449568;49669762;2056046;2177;76.7;74.0;3.1;0.0
FR;2021-10-18;28246;42678;71331;38;51477814;49712440;2127377;2215;76.7;74.1;3.2;0.0
FR;2021-10-19;27034;42065;81600;72;51504848;49754505;2208977;2287;76.7;74.1;3.3;0.0
FR;2021-10-20;35190;51882;101451;95;51540038;49806387;2310428;2382;76.8;74.2;3.4;0.0
FR;2021-10-21;25913;42016;89097;45;51565951;49848403;2399525;2427;76.8;74.3;3.6;0.0
FR;2021-10-22;38180;59317;112475;91;51604131;49907720;2512000;2518;76.9;74.4;3.7;0.0
FR;2021-10-23;26957;42458;48594;24;51631088;49950178;2560594;2542;76.9;74.4;3.8;0.0
FR;2021-10-24;2912;5021;3937;3;51634000;49955199;2564531;2545;76.9;74.4;3.8;0.0
FR;2021-10-25;25972;35627;86593;67;51659972;49990826;2651124;2612;77.0;74.5;4.0;0.0
FR;2021-10-26;23680;32285;92300;48;51683652;50023111;2743424;2660;77.0;74.5;4.1;0.0
FR;2021-10-27;30003;44202;114603;73;51713655;50067313;2858027;2733;77.1;74.6;4.3;0.0
FR;2021-10-28;23374;31217;94361;63;51737029;50098530;2952388;2796;77.1;74.6;4.4;0.0
FR;2021-10-29;31495;46485;125233;80;51768524;50145015;3077621;2876;77.1;74.7;4.6;0.0
FR;2021-10-30;20520;32840;53352;27;51789044;50177855;3130973;2903;77.2;74.8;4.7;0.0
FR;2021-10-31;2477;3878;3867;3;51791521;50181733;3134840;2906;77.2;74.8;4.7;0.0
FR;2021-11-01;8189;4957;3552;10;51799710;50186690;3138392;2916;77.2;74.8;4.7;0.0
FR;2021-11-02;25259;36347;99457;64;51824969;50223037;3237849;2980;77.2;74.8;4.8;0.0
FR;2021-11-03;29742;43594;125765;97;51854711;50266631;3363614;3077;77.3;74.9;5.0;0.0
FR;2021-11-04;23654;31637;114311;70;51878365;50298268;3477925;3147;77.3;74.9;5.2;0.0
FR;2021-11-05;32259;44727;151246;85;51910624;50342995;3629171;3232;77.3;75.0;5.4;0.0
FR;2021-11-06;21476;32465;68220;41;51932100;50375460;3697391;3273;77.4;75.1;5.5;0.0
FR;2021-11-07;2377;4062;5584;8;51934477;50379522;3702975;3281;77.4;75.1;5.5;0.0
FR;2021-11-08;20383;31079;134149;73;51954860;50410601;3837124;3354;77.4;75.1;5.7;0.0
FR;2021-11-09;22118;33099;172095;107;51976978;50443700;4009219;3461;77.4;75.2;6.0;0.0
FR;2021-11-10;31346;44238;198660;129;52008324;50487938;4207879;3590;77.5;75.2;6.3;0.0
FR;2021-11-11;4289;5847;13923;20;52012613;50493785;4221802;3610;77.5;75.2;6.3;0.0
FR;2021-11-12;28982;41882;197253;129;52041595;50535667;4419055;3739;77.5;75.3;6.6;0.0
FR;2021-11-13;20286;28359;86288;60;52061881;50564026;4505343;3799;77.6;75.3;6.7;0.0
FR;2021-11-14;2323;3408;7877;10;52064204;50567434;4513220;3809;77.6;75.3;6.7;0.0
FR;2021-11-15;20283;28090;171432;103;52084487;50595524;4684652;3912;77.6;75.4;7.0;0.0
FR;2021-11-16;23322;28009;214858;152;52107809;50623533;4899510;4064;77.6;75.4;7.3;0.0
FR;2021-11-17;30334;36741;212775;132;52138143;50660274;5112285;4196;77.7;75.5;7.6;0.0
FR;2021-11-18;23337;28776;205387;124;52161480;50689050;5317672;4320;77.7;75.5;7.9;0.0
FR;2021-11-19;33546;40099;262055;187;52195026;50729149;5579727;4507;77.8;75.6;8.3;0.0
FR;2021-11-20;25311;29396;109656;63;52220337;50758545;5689383;4570;77.8;75.6;8.5;0.0
FR;2021-11-21;2622;3484;10644;17;52222959;50762029;5700027;4587;77.8;75.6;8.5;0.0
FR;2021-11-22;22710;19164;194732;85;52245669;50781193;5894759;4672;77.8;75.7;8.8;0.0
FR;2021-11-23;25544;24464;247700;82;52271213;50805657;6142459;4754;77.9;75.7;9.2;0.0
FR;2021-11-24;31760;34773;243107;80;52302973;50840430;6385566;4834;77.9;75.8;9.5;0.0
FR;2021-11-25;25381;25195;277579;110;52328354;50865625;6663145;4944;78.0;75.8;9.9;0.0
FR;2021-11-26;33201;37584;414489;160;52361555;50903209;7077634;5104;78.0;75.8;10.5;0.0
FR;2021-11-27;23292;28651;236547;150;52384847;50931860;7314181;5254;78.1;75.9;10.9;0.0
FR;2021-11-28;3478;4127;63329;41;52388325;50935987;7377510;5295;78.1;75.9;11.0;0.0
FR;2021-11-29;19384;23455;371533;175;52407709;50959442;7749043;5470;78.1;75.9;11.5;0.0
FR;2021-11-30;24675;27268;500624;281;52432384;50986710;8249667;5751;78.1;76.0;12.3;0.0
FR;2021-12-01;26812;31866;511165;300;52459196;51018576;8760832;6051;78.2;76.0;13.1;0.0
FR;2021-12-02;21959;21376;574686;302;52481155;51039952;9335518;6353;78.2;76.0;13.9;0.0
FR;2021-12-03;25455;34145;650958;325;52506610;51074097;9986476;6678;78.2;76.1;14.9;0.0
FR;2021-12-04;18285;25907;369686;216;52524895;51100004;10356162;6894;78.3;76.1;15.4;0.0
FR;2021-12-05;4141;4962;107048;94;52529036;51104966;10463210;6988;78.3;76.1;15.6;0.0
FR;2021-12-06;22434;25744;539809;383;52551470;51130710;11003019;7371;78.3;76.2;16.4;0.0
FR;2021-12-07;23299;29182;706129;407;52574769;51159892;11709148;7778;78.3;76.2;17.4;0.0
FR;2021-12-08;25324;35417;647306;436;52600093;51195309;12356454;8214;78.4;76.3;18.4;0.0
FR;2021-12-09;23989;29484;726171;454;52624082;51224793;13082625;8668;78.4;76.3;19.5;0.0
FR;2021-12-10;27623;38314;805973;461;52651705;51263107;13888598;9129;78.4;76.4;20.7;0.0
FR;2021-12-11;20216;29939;480314;353;52671921;51293046;14368912;9482;78.5;76.4;21.4;0.0
FR;2021-12-12;5624;6462;159223;107;52677545;51299508;14528135;9589;78.5;76.4;21.6;0.0
FR;2021-12-13;21046;30164;649185;393;52698591;51329672;15177320;9982;78.5;76.5;22.6;0.0
FR;2021-12-14;27531;35825;847349;681;52726122;51365497;16024669;10663;78.6;76.5;23.9;0.0
FR;2021-12-15;28178;39889;768894;490;52754300;51405386;16793563;11153;78.6;76.6;25.0;0.0
FR;2021-12-16;27923;35607;844252;504;52782223;51440993;17637815;11657;78.6;76.6;26.3;0.0
FR;2021-12-17;31529;43764;891975;592;52813752;51484757;18529790;12249;78.7;76.7;27.6;0.0
FR;2021-12-18;24913;30226;522141;365;52838665;51514983;19051931;12614;78.7;76.8;28.4;0.0
FR;2021-12-19;8740;7958;191143;141;52847405;51522941;19243074;12755;78.7;76.8;28.7;0.0
FR;2021-12-20;31585;34242;658583;488;52878990;51557183;19901657;13243;78.8;76.8;29.7;0.0
FR;2021-12-21;39209;39207;759446;578;52918199;51596390;20661103;13821;78.8;76.9;30.8;0.0
FR;2021-12-22;39455;37470;642024;702;52957654;51633860;21303127;14523;78.9;76.9;31.7;0.0
FR;2021-12-23;33734;30361;494317;592;52991388;51664221;21797444;15115;79.0;77.0;32.5;0.0
FR;2021-12-24;10663;11610;126629;239;53002051;51675831;21924073;15354;79.0;77.0;32.7;0.0
FR;2021-12-25;767;1937;9030;72;53002818;51677768;21933103;15426;79.0;77.0;32.7;0.0
FR;2021-12-26;4696;4759;60129;169;53007514;51682527;21993232;15595;79.0;77.0;32.8;0.0
FR;2021-12-27;30323;33159;509080;673;53037837;51715686;22502312;16268;79.0;77.1;33.5;0.0
FR;2021-12-28;38300;35304;632146;1556;53076137;51750990;23134458;17824;79.1;77.1;34.5;0.0
FR;2021-12-29;39840;33258;560919;1752;53115977;51784248;23695377;19576;79.1;77.2;35.3;0.0
FR;2021-12-30;35882;29361;471079;1881;53151859;51813609;24166456;21457;79.2;77.2;36.0;0.0
FR;2021-12-31;12033;11338;131619;755;53163892;51824947;24298075;22212;79.2;77.2;36.2;0.0
FR;2022-01-01;1303;1762;9927;100;53165195;51826709;24308002;22312;79.2;77.2;36.2;0.0
FR;2022-01-02;6073;5086;66929;408;53171268;51831795;24374931;22720;79.2;77.2;36.3;0.0
FR;2022-01-03;32508;36536;551467;2642;53203776;51868331;24926398;25362;79.3;77.3;37.1;0.0
FR;2022-01-04;40819;40489;714196;3838;53244595;51908820;25640594;29200;79.3;77.3;38.2;0.0
FR;2022-01-05;60293;43332;634043;3436;53304888;51952152;26274637;32636;79.4;77.4;39.1;0.0
FR;2022-01-06;43912;40042;711310;4564;53348800;51992194;26985947;37200;79.5;77.5;40.2;0.1
FR;2022-01-07;50537;46559;790322;5003;53399337;52038753;27776269;42203;79.6;77.5;41.4;0.1
FR;2022-01-08;44950;35000;472839;2443;53444287;52073753;28249108;44646;79.6;77.6;42.1;0.1
FR;2022-01-09;15597;11490;145697;830;53459884;52085243;28394805;45476;79.7;77.6;42.3;0.1
FR;2022-01-10;34971;38201;522135;3720;53494855;52123444;28916940;49196;79.7;77.7;43.1;0.1
FR;2022-01-11;41629;41952;608382;5218;53536484;52165396;29525322;54414;79.8;77.7;44.0;0.1
FR;2022-01-12;60123;49176;504221;4492;53596607;52214572;30029543;58906;79.9;77.8;44.7;0.1
FR;2022-01-13;37876;40239;540915;5462;53634483;52254811;30570458;64368;79.9;77.9;45.5;0.1
FR;2022-01-14;42372;43330;628953;6460;53676855;52298141;31199411;70828;80.0;77.9;46.5;0.1
FR;2022-01-15;39300;31254;377533;3289;53716155;52329395;31576944;74117;80.0;78.0;47.0;0.1
FR;2022-01-16;11381;9006;99450;760;53727536;52338401;31676394;74877;80.1;78.0;47.2;0.1
FR;2022-01-17;24589;28002;354137;3961;53752125;52366403;32030531;78838;80.1;78.0;47.7;0.1
FR;2022-01-18;28100;31686;397497;5774;53780225;52398089;32428028;84612;80.1;78.1;48.3;0.1
FR;2022-01-19;43031;40232;311037;4386;53823256;52438321;32739065;88998;80.2;78.1;48.8;0.1
FR;2022-01-20;23400;29297;328391;5627;53846656;52467618;33067456;94625;80.2;78.2;49.3;0.1
FR;2022-01-21;27984;32959;401111;6581;53874640;52500577;33468567;101206;80.3;78.2;49.9;0.2
FR;2022-01-22;27605;27139;241742;2842;53902245;52527716;33710309;104048;80.3;78.3;50.2;0.2
FR;2022-01-23;6701;7512;55183;589;53908946;52535228;33765492;104637;80.3;78.3;50.3;0.2
FR;2022-01-24;16193;25023;239317;4094;53925139;52560251;34004809;108731;80.3;78.3;50.7;0.2
FR;2022-01-25;18897;28515;267026;6066;53944036;52588766;34271835;114797;80.4;78.4;51.1;0.2
FR;2022-01-26;28103;41000;229336;4474;53972139;52629766;34501171;119271;80.4;78.4;51.4;0.2
FR;2022-01-27;16270;25628;225793;5690;53988409;52655394;34726964;124961;80.4;78.5;51.7;0.2
FR;2022-01-28;21498;41799;321455;7409;54009907;52697193;35048419;132370;80.5;78.5;52.2;0.2
FR;2022-01-29;18401;32666;204565;3249;54028308;52729859;35252984;135619;80.5;78.6;52.5;0.2
FR;2022-01-30;4466;9158;45092;639;54032774;52739017;35298076;136258;80.5;78.6;52.6;0.2
FR;2022-01-31;11219;25957;164780;4243;54043993;52764974;35462856;140501;80.5;78.6;52.8;0.2
FR;2022-02-01;12790;27075;191354;7098;54056783;52792049;35654210;147599;80.5;78.7;53.1;0.2
FR;2022-02-02;19957;45618;190116;5992;54076740;52837667;35844326;153591;80.6;78.7;53.4;0.2
FR;2022-02-03;10935;24609;173289;6969;54087675;52862276;36017615;160560;80.6;78.8;53.7;0.2
FR;2022-02-04;14472;35920;264163;9207;54102147;52898196;36281778;169767;80.6;78.8;54.1;0.3
FR;2022-02-05;12770;31932;172332;3816;54114917;52930128;36454110;173583;80.6;78.9;54.3;0.3
FR;2022-02-06;2706;7327;33828;663;54117623;52937455;36487938;174246;80.6;78.9;54.4;0.3
FR;2022-02-07;9280;24406;176313;5288;54126903;52961861;36664251;179534;80.6;78.9;54.6;0.3
FR;2022-02-08;9586;20499;184318;7049;54136489;52982360;36848569;186583;80.7;78.9;54.9;0.3
FR;2022-02-09;14147;34896;192950;5775;54150636;53017256;37041519;192358;80.7;79.0;55.2;0.3
FR;2022-02-10;8253;17829;166567;6494;54158889;53035085;37208086;198852;80.7;79.0;55.4;0.3
FR;2022-02-11;10732;25592;242994;8324;54169621;53060677;37451080;207176;80.7;79.1;55.8;0.3
FR;2022-02-12;8342;22545;151702;3502;54177963;53083222;37602782;210678;80.7;79.1;56.0;0.3
FR;2022-02-13;1892;4388;30902;540;54179855;53087610;37633684;211218;80.7;79.1;56.1;0.3
FR;2022-02-14;6887;14493;166299;4774;54186742;53102103;37799983;215992;80.7;79.1;56.3;0.3
FR;2022-02-15;6850;15223;162426;6846;54193592;53117326;37962409;222838;80.7;79.1;56.6;0.3
FR;2022-02-16;9281;25564;146639;5720;54202873;53142890;38109048;228558;80.8;79.2;56.8;0.3
FR;2022-02-17;5363;12526;94750;5404;54208236;53155416;38203798;233962;80.8;79.2;56.9;0.3
FR;2022-02-18;6873;18401;129234;7399;54215109;53173817;38333032;241361;80.8;79.2;57.1;0.4
FR;2022-02-19;5340;15800;77297;3016;54220449;53189617;38410329;244377;80.8;79.3;57.2;0.4
FR;2022-02-20;1135;2882;13922;459;54221584;53192499;38424251;244836;80.8;79.3;57.3;0.4
FR;2022-02-21;4018;10032;67133;4058;54225602;53202531;38491384;248894;80.8;79.3;57.4;0.4
FR;2022-02-22;4362;11087;64404;5249;54229964;53213618;38555788;254143;80.8;79.3;57.4;0.4
FR;2022-02-23;6507;19376;71852;4590;54236471;53232994;38627640;258733;80.8;79.3;57.6;0.4
FR;2022-02-24;3743;9107;53171;4529;54240214;53242101;38680811;263262;80.8;79.3;57.6;0.4
FR;2022-02-25;5194;14519;79990;7327;54245408;53256620;38760801;270589;80.8;79.4;57.8;0.4
FR;2022-02-26;3969;12021;51450;3083;54249377;53268641;38812251;273672;80.8;79.4;57.8;0.4
FR;2022-02-27;867;1954;8931;529;54250244;53270595;38821182;274201;80.8;79.4;57.8;0.4
FR;2022-02-28;3065;7149;42867;3847;54253309;53277744;38864049;278048;80.8;79.4;57.9;0.4
FR;2022-03-01;3108;7261;44756;5508;54256417;53285005;38908805;283556;80.8;79.4;58.0;0.4
FR;2022-03-02;5067;12495;48980;4919;54261484;53297500;38957785;288475;80.8;79.4;58.0;0.4
FR;2022-03-03;2644;5767;29918;4042;54264128;53303267;38987703;292517;80.9;79.4;58.1;0.4
FR;2022-03-04;3175;8170;39382;6208;54267303;53311437;39027085;298725;80.9;79.4;58.1;0.4
FR;2022-03-05;2914;7057;25071;3130;54270217;53318494;39052156;301855;80.9;79.4;58.2;0.4
FR;2022-03-06;508;1008;3429;378;54270725;53319502;39055585;302233;80.9;79.4;58.2;0.5
FR;2022-03-07;1929;3687;17647;3298;54272654;53323189;39073232;305531;80.9;79.5;58.2;0.5
FR;2022-03-08;1961;4141;17856;4088;54274615;53327330;39091088;309619;80.9;79.5;58.2;0.5
FR;2022-03-09;3445;8489;21219;4029;54278060;53335819;39112307;313648;80.9;79.5;58.3;0.5
FR;2022-03-10;1705;3731;15670;3391;54279765;53339550;39127977;317039;80.9;79.5;58.3;0.5
FR;2022-03-11;2340;5162;22216;5467;54282105;53344712;39150193;322506;80.9;79.5;58.3;0.5
FR;2022-03-12;2654;5424;16497;3132;54284759;53350136;39166690;325638;80.9;79.5;58.4;0.5
FR;2022-03-13;385;589;2251;529;54285144;53350725;39168941;326167;80.9;79.5;58.4;0.5
FR;2022-03-14;1455;2654;13782;7277;54286599;53353379;39182723;333444;80.9;79.5;58.4;0.5
FR;2022-03-15;1591;2991;14329;11012;54288190;53356370;39197052;344456;80.9;79.5;58.4;0.5
FR;2022-03-16;2939;5824;17998;16285;54291129;53362194;39215050;360741;80.9;79.5;58.4;0.5
FR;2022-03-17;1366;2483;11926;13293;54292495;53364677;39226976;374034;80.9;79.5;58.4;0.6
FR;2022-03-18;2193;3842;18013;22007;54294688;53368519;39244989;396041;80.9;79.5;58.5;0.6
FR;2022-03-19;2274;3996;12399;11402;54296962;53372515;39257388;407443;80.9;79.5;58.5;0.6
FR;2022-03-20;291;501;1914;1332;54297253;53373016;39259302;408775;80.9;79.5;58.5;0.6
FR;2022-03-21;1337;2053;11897;16896;54298590;53375069;39271199;425671;80.9;79.5;58.5;0.6
FR;2022-03-22;1455;2406;12505;22809;54300045;53377475;39283704;448480;80.9;79.5;58.5;0.7
FR;2022-03-23;2631;4993;17131;25240;54302676;53382468;39300835;473720;80.9;79.5;58.6;0.7
FR;2022-03-24;1352;2006;10601;19349;54304028;53384474;39311436;493069;80.9;79.5;58.6;0.7
FR;2022-03-25;2038;3326;16805;30769;54306066;53387800;39328241;523838;80.9;79.5;58.6;0.8
FR;2022-03-26;2214;3687;11494;14373;54308280;53391487;39339735;538211;80.9;79.6;58.6;0.8
FR;2022-03-27;352;499;1907;1730;54308632;53391986;39341642;539941;80.9;79.6;58.6;0.8
FR;2022-03-28;1409;1945;10529;19023;54310041;53393931;39352171;558964;80.9;79.6;58.6;0.8
FR;2022-03-29;1419;2021;11985;29230;54311460;53395952;39364156;588194;80.9;79.6;58.7;0.9
FR;2022-03-30;2804;4541;14981;29250;54314264;53400493;39379137;617444;80.9;79.6;58.7;0.9
FR;2022-03-31;1584;2102;12133;26460;54315848;53402595;39391270;643904;80.9;79.6;58.7;1.0
FR;2022-04-01;2070;2633;18579;33400;54317918;53405228;39409849;677304;80.9;79.6;58.7;1.0
FR;2022-04-02;1487;1964;8671;11266;54319405;53407192;39418520;688570;80.9;79.6;58.7;1.0
FR;2022-04-03;270;337;1570;1378;54319675;53407529;39420090;689948;80.9;79.6;58.7;1.0
FR;2022-04-04;1302;1542;11270;20495;54320977;53409071;39431360;710443;80.9;79.6;58.8;1.1
FR;2022-04-05;1574;1786;13051;35578;54322551;53410857;39444411;746021;80.9;79.6;58.8;1.1
FR;2022-04-06;2020;2673;12614;27770;54324571;53413530;39457025;773791;80.9;79.6;58.8;1.2
FR;2022-04-07;1414;1682;12753;34876;54325985;53415212;39469778;808667;80.9;79.6;58.8;1.2
FR;2022-04-08;2004;2383;17702;45919;54327989;53417595;39487480;854586;80.9;79.6;58.8;1.3
FR;2022-04-09;1340;1868;8831;14766;54329329;53419463;39496311;869352;80.9;79.6;58.8;1.3
FR;2022-04-10;269;358;1968;2252;54329598;53419821;39498279;871604;81.0;79.6;58.9;1.3
FR;2022-04-11;1170;1457;11393;24894;54330768;53421278;39509672;896498;81.0;79.6;58.9;1.3
FR;2022-04-12;1554;1646;13211;41326;54332322;53422924;39522883;937824;81.0;79.6;58.9;1.4
FR;2022-04-13;1830;2391;12826;33654;54334152;53425315;39535709;971478;81.0;79.6;58.9;1.4
FR;2022-04-14;1422;1581;12823;36529;54335574;53426896;39548532;1008007;81.0;79.6;58.9;1.5
FR;2022-04-15;1755;2034;14689;36816;54337329;53428930;39563221;1044823;81.0;79.6;58.9;1.6
FR;2022-04-16;1023;1228;6201;9399;54338352;53430158;39569422;1054222;81.0;79.6;59.0;1.6
FR;2022-04-17;182;197;1026;1221;54338534;53430355;39570448;1055443;81.0;79.6;59.0;1.6
FR;2022-04-18;142;227;2730;1247;54338676;53430582;39573178;1056690;81.0;79.6;59.0;1.6
FR;2022-04-19;1455;1734;12247;30375;54340131;53432316;39585425;1087065;81.0;79.6;59.0;1.6
FR;2022-04-20;1877;2402;12759;29611;54342008;53434718;39598184;1116676;81.0;79.6;59.0;1.7
FR;2022-04-21;1463;1667;12393;35174;54343471;53436385;39610577;1151850;81.0;79.6;59.0;1.7
FR;2022-04-22;1799;2197;15704;38783;54345270;53438582;39626281;1190633;81.0;79.6;59.0;1.8
FR;2022-04-23;1101;1434;7190;11405;54346371;53440016;39633471;1202038;81.0;79.6;59.1;1.8
FR;2022-04-24;232;300;1395;1827;54346603;53440316;39634866;1203865;81.0;79.6;59.1;1.8
FR;2022-04-25;1229;1479;10361;21785;54347832;53441795;39645227;1225650;81.0;79.6;59.1;1.8
FR;2022-04-26;1539;1856;12956;38896;54349371;53443651;39658183;1264546;81.0;79.6;59.1;1.9
FR;2022-04-27;1875;2177;11400;30842;54351246;53445828;39669583;1295388;81.0;79.6;59.1;1.9
FR;2022-04-28;1499;1680;12012;35830;54352745;53447508;39681595;1331218;81.0;79.6;59.1;2.0
FR;2022-04-29;1922;2182;14590;38133;54354667;53449690;39696185;1369351;81.0;79.6;59.1;2.0
FR;2022-04-30;1171;1254;6537;10512;54355838;53450944;39702722;1379863;81.0;79.6;59.2;2.1
FR;2022-05-01;165;197;857;1075;54356003;53451141;39703579;1380938;81.0;79.6;59.2;2.1
FR;2022-05-02;1118;1214;9835;18450;54357121;53452355;39713414;1399388;81.0;79.6;59.2;2.1
FR;2022-05-03;1698;1681;12789;34779;54358819;53454036;39726203;1434167;81.0;79.6;59.2;2.1
FR;2022-05-04;1773;1858;10870;25482;54360592;53455894;39737073;1459649;81.0;79.6;59.2;2.2
FR;2022-05-05;1569;1587;11231;33279;54362161;53457481;39748304;1492928;81.0;79.7;59.2;2.2
FR;2022-05-06;2011;2104;14128;37615;54364172;53459585;39762432;1530543;81.0;79.7;59.2;2.3
FR;2022-05-07;1151;1198;6073;10217;54365323;53460783;39768505;1540760;81.0;79.7;59.3;2.3
FR;2022-05-08;247;247;1081;1596;54365570;53461030;39769586;1542356;81.0;79.7;59.3;2.3
FR;2022-05-09;1199;1141;8350;20447;54366769;53462171;39777936;1562803;81.0;79.7;59.3;2.3
FR;2022-05-10;1585;1637;11620;38819;54368354;53463808;39789556;1601622;81.0;79.7;59.3;2.4
FR;2022-05-11;1885;1923;9551;27494;54370239;53465731;39799107;1629116;81.0;79.7;59.3;2.4
FR;2022-05-12;1464;1492;10087;35244;54371703;53467223;39809194;1664360;81.0;79.7;59.3;2.5
FR;2022-05-13;1878;1828;12383;37887;54373581;53469051;39821577;1702247;81.0;79.7;59.3;2.5
FR;2022-05-14;1094;1070;5242;11081;54374675;53470121;39826819;1713328;81.0;79.7;59.3;2.6
FR;2022-05-15;253;209;1178;1511;54374928;53470330;39827997;1714839;81.0;79.7;59.3;2.6
FR;2022-05-16;1087;1004;7090;20214;54376015;53471334;39835087;1735053;81.0;79.7;59.4;2.6
FR;2022-05-17;1452;1400;9731;36369;54377467;53472734;39844818;1771422;81.0;79.7;59.4;2.6
FR;2022-05-18;1623;1653;7983;25294;54379090;53474387;39852801;1796716;81.0;79.7;59.4;2.7
